公表_年月日,男性,女性,非公表,重複削除,日計
2020-01-28,0,1,0,0,1
2020-02-14,1,0,0,0,1
2020-02-19,3,0,0,0,3
2020-02-21,2,1,0,0,3
2020-02-22,5,5,0,0,10
2020-02-23,4,4,0,0,8
2020-02-24,2,2,0,0,4
2020-02-25,3,2,0,0,5
2020-02-26,1,2,1,0,4
2020-02-27,14,1,0,0,15
2020-02-28,8,4,0,0,12
2020-02-29,0,4,0,0,4
2020-03-01,1,1,0,0,2
2020-03-02,4,1,0,0,5
2020-03-03,0,2,0,0,2
2020-03-04,3,0,0,0,3
2020-03-05,1,0,0,0,1
2020-03-06,5,2,0,0,7
2020-03-07,4,4,0,0,8
2020-03-08,2,1,0,0,3
2020-03-09,4,3,0,0,7
2020-03-10,2,1,0,0,3
2020-03-11,2,5,0,0,7
2020-03-12,5,5,0,0,10
2020-03-13,7,7,0,0,14
2020-03-14,0,2,0,0,2
2020-03-15,3,1,0,0,4
2020-03-16,2,2,0,0,4
2020-03-18,1,1,0,0,2
2020-03-19,2,1,0,0,3
2020-03-20,1,0,0,0,1
2020-03-21,1,0,0,0,1
2020-03-22,1,2,0,0,3
2020-03-24,0,1,0,0,1
2020-03-25,3,1,0,0,4
2020-03-26,0,1,0,0,1
2020-03-27,1,0,0,0,1
2020-03-28,3,0,0,0,3
2020-03-29,2,2,0,0,4
2020-03-30,0,1,0,0,1
2020-04-01,4,1,0,0,5
2020-04-02,3,0,0,0,3
2020-04-03,4,0,1,0,5
2020-04-04,2,1,0,0,3
2020-04-05,0,1,0,0,1
2020-04-07,1,3,0,0,4
2020-04-08,5,5,0,0,10
2020-04-09,7,11,0,0,18
2020-04-10,10,3,0,0,13
2020-04-11,8,7,1,0,16
2020-04-12,8,4,0,0,12
2020-04-13,2,2,1,0,5
2020-04-14,11,7,0,0,18
2020-04-15,12,10,1,0,23
2020-04-16,9,14,0,0,23
2020-04-17,21,12,0,0,33
2020-04-18,20,18,0,0,38
2020-04-19,12,13,2,0,27
2020-04-20,8,8,1,0,17
2020-04-21,4,17,1,0,22
2020-04-22,10,12,0,0,22
2020-04-23,17,26,2,0,45
2020-04-24,10,11,1,0,22
2020-04-25,16,23,0,0,39
2020-04-26,5,8,1,0,14
2020-04-27,11,22,2,0,35
2020-04-28,14,23,1,0,38
2020-04-29,14,24,0,0,38
2020-04-30,13,28,0,0,41
2020-05-01,5,17,1,0,23
2020-05-02,13,20,0,0,33
2020-05-03,12,12,1,0,25
2020-05-04,12,18,1,0,31
2020-05-05,6,6,0,0,12
2020-05-06,5,14,4,0,23
2020-05-07,5,9,0,0,14
2020-05-08,2,4,0,0,6
2020-05-09,3,7,1,0,11
2020-05-10,4,3,2,0,9
2020-05-11,6,3,3,0,12
2020-05-12,8,4,1,0,13
2020-05-13,1,3,0,0,4
2020-05-14,2,4,0,0,6
2020-05-15,4,3,3,0,10
2020-05-16,2,4,1,0,7
2020-05-17,3,4,1,0,8
2020-05-18,0,0,1,0,1
2020-05-19,1,2,0,0,3
2020-05-20,1,0,0,0,1
2020-05-21,2,3,0,0,5
2020-05-22,4,2,0,0,6
2020-05-23,2,5,2,0,9
2020-05-24,5,7,3,0,15
2020-05-25,2,1,0,0,3
2020-05-26,6,3,0,0,9
2020-05-27,3,0,2,0,5
2020-05-28,1,4,2,0,7
2020-05-29,0,2,1,0,3
2020-05-30,1,3,0,0,4
2020-05-31,2,4,0,0,6
2020-06-01,2,2,1,0,5
2020-06-02,1,1,1,0,3
2020-06-03,1,1,1,0,3
2020-06-04,2,1,0,0,3
2020-06-05,1,2,1,0,4
2020-06-06,3,2,3,0,8
2020-06-07,2,0,2,0,4
2020-06-08,1,2,1,0,4
2020-06-09,2,2,3,0,7
2020-06-10,2,1,2,0,5
2020-06-11,5,1,1,0,7
2020-06-12,6,3,1,0,10
2020-06-13,2,7,0,0,9
2020-06-14,3,4,0,0,7
2020-06-15,2,3,1,0,6
2020-06-16,0,2,0,0,2
2020-06-17,2,3,1,0,6
2020-06-18,2,3,0,0,5
2020-06-19,1,1,1,0,3
2020-06-20,1,2,0,0,3
2020-06-21,1,1,0,0,2
2020-06-22,1,0,1,0,2
2020-06-23,0,0,1,0,1
2020-06-24,4,3,3,0,10
2020-06-25,2,3,1,0,6
2020-06-26,4,1,0,0,5
2020-06-27,0,0,1,0,1
2020-06-28,3,11,3,0,17
2020-06-29,2,9,0,0,11
2020-06-30,1,12,0,0,13
2020-07-01,2,2,0,0,4
2020-07-02,6,2,0,0,8
2020-07-04,1,0,0,0,1
2020-07-05,0,0,1,0,1
2020-07-07,0,0,1,0,1
2020-07-08,0,3,1,0,4
2020-07-09,0,0,1,0,1
2020-07-10,3,1,2,0,6
2020-07-11,0,0,1,0,1
2020-07-12,3,0,1,0,4
2020-07-13,1,1,0,0,2
2020-07-14,4,4,0,0,8
2020-07-15,2,9,2,0,13
2020-07-16,3,2,1,0,6
2020-07-17,2,0,1,0,3
2020-07-18,8,2,3,0,13
2020-07-19,5,2,2,0,9
2020-07-20,1,1,1,0,3
2020-07-21,3,4,3,0,10
2020-07-22,5,0,1,0,6
2020-07-23,1,2,1,0,4
2020-07-24,3,3,0,0,6
2020-07-25,4,4,1,0,9
2020-07-26,3,1,1,0,5
2020-07-27,0,4,1,0,5
2020-07-28,0,3,0,0,3
2020-07-29,1,2,2,0,5
2020-07-30,1,8,0,0,9
2020-07-31,6,8,1,0,15
2020-08-01,4,8,6,0,18
2020-08-02,3,4,2,0,9
2020-08-03,2,14,7,0,23
2020-08-04,3,7,1,0,11
2020-08-05,5,6,3,0,14
2020-08-06,5,4,2,0,11
2020-08-07,7,2,5,0,14
2020-08-08,6,5,2,0,13
2020-08-09,8,2,1,0,11
2020-08-10,5,6,2,0,13
2020-08-11,5,7,2,0,14
2020-08-12,3,1,0,0,4
2020-08-13,3,3,4,0,10
2020-08-14,8,4,0,0,12
2020-08-15,7,5,2,0,14
2020-08-16,3,4,1,0,8
2020-08-17,1,1,3,0,5
2020-08-18,4,1,1,0,6
2020-08-19,5,2,1,0,8
2020-08-20,4,11,10,0,25
2020-08-21,6,3,1,0,10
2020-08-22,4,8,5,0,17
2020-08-23,6,4,4,0,14
2020-08-24,3,1,4,0,8
2020-08-25,1,4,2,0,7
2020-08-26,0,5,2,0,7
2020-08-27,2,8,0,0,10
2020-08-28,8,6,2,0,16
2020-08-29,3,4,2,0,9
2020-08-30,2,1,1,0,4
2020-08-31,3,2,3,0,8
2020-09-01,9,5,2,0,16
2020-09-02,4,1,1,0,6
2020-09-03,3,3,0,0,6
2020-09-04,2,3,0,0,5
2020-09-05,3,5,2,0,10
2020-09-06,3,1,0,0,4
2020-09-07,2,3,1,0,6
2020-09-08,5,4,2,0,11
2020-09-09,3,0,1,0,4
2020-09-10,5,6,0,0,11
2020-09-11,0,4,2,0,6
2020-09-12,2,3,2,0,7
2020-09-13,2,0,1,0,3
2020-09-14,0,3,5,0,8
2020-09-15,2,4,2,0,8
2020-09-16,5,2,4,0,11
2020-09-17,4,2,1,0,7
2020-09-18,6,5,6,0,17
2020-09-19,5,8,4,0,17
2020-09-20,10,5,1,0,16
2020-09-21,6,4,5,0,15
2020-09-22,4,5,0,0,9
2020-09-23,6,5,1,0,12
2020-09-24,4,6,1,0,11
2020-09-25,11,11,3,0,25
2020-09-26,4,2,1,0,7
2020-09-27,10,6,3,0,19
2020-09-28,7,7,3,0,17
2020-09-29,8,4,4,0,16
2020-09-30,7,7,2,0,16
2020-10-01,7,7,5,0,19
2020-10-02,9,5,1,0,15
2020-10-03,6,10,2,0,18
2020-10-04,10,8,4,0,22
2020-10-05,10,21,5,0,36
2020-10-06,5,5,2,0,12
2020-10-07,17,15,6,0,38
2020-10-08,6,16,7,0,29
2020-10-09,12,10,5,0,27
2020-10-10,14,7,3,0,24
2020-10-11,15,12,4,0,31
2020-10-12,4,5,3,0,12
2020-10-13,4,6,10,0,20
2020-10-14,8,6,6,0,20
2020-10-15,19,9,2,0,30
2020-10-16,15,12,4,0,31
2020-10-17,10,12,5,0,27
2020-10-18,10,10,4,0,24
2020-10-19,6,6,5,0,17
2020-10-20,8,18,5,0,31
2020-10-21,17,2,3,0,22
2020-10-22,16,17,7,0,40
2020-10-23,17,22,12,0,51
2020-10-24,18,24,18,0,60
2020-10-25,15,16,10,0,41
2020-10-26,17,21,12,0,50
2020-10-27,9,13,5,0,27
2020-10-28,23,20,9,0,52
2020-10-29,23,23,7,0,53
2020-10-30,36,18,15,0,69
2020-10-31,45,27,9,0,81
2020-11-01,30,31,8,0,69
2020-11-02,39,33,24,0,96
2020-11-03,30,25,16,0,71
2020-11-04,33,22,20,0,75
2020-11-05,52,44,23,0,119
2020-11-06,57,46,12,0,115
2020-11-07,75,91,21,0,187
2020-11-08,70,69,14,0,153
2020-11-09,96,77,27,0,200
2020-11-10,61,88,17,0,166
2020-11-11,90,82,25,0,197
2020-11-12,107,110,19,0,236
2020-11-13,110,104,21,0,235
2020-11-14,113,93,24,0,230
2020-11-15,91,97,21,0,209
2020-11-16,83,74,32,0,189
2020-11-17,97,82,18,0,197
2020-11-18,111,91,31,0,233
2020-11-19,118,120,29,0,267
2020-11-20,130,140,34,0,304
2020-11-21,98,111,25,0,234
2020-11-22,116,100,29,0,245
2020-11-23,91,92,22,1,205
2020-11-24,103,104,9,0,216
2020-11-25,91,80,10,0,181
2020-11-26,125,110,21,0,256
2020-11-27,116,112,24,0,252
2020-11-28,95,139,18,0,252
2020-11-29,77,96,19,0,192
2020-11-30,55,83,13,0,151
2020-12-01,84,99,23,0,206
2020-12-02,72,67,35,2,174
2020-12-03,84,100,22,0,206
2020-12-04,86,97,29,0,212
2020-12-05,76,84,23,0,183
2020-12-06,82,85,20,0,187
2020-12-07,56,53,15,0,124
2020-12-08,76,97,31,0,204
2020-12-09,79,89,29,0,197
2020-12-10,98,107,36,0,241
2020-12-11,89,70,18,0,177
2020-12-12,72,87,29,1,188
2020-12-13,64,72,28,0,164
2020-12-14,56,52,17,0,125
2020-12-15,34,57,13,0,104
2020-12-16,37,42,7,0,86
2020-12-17,58,62,19,0,139
2020-12-18,52,60,29,0,141
2020-12-19,44,56,32,0,132
2020-12-20,50,53,32,0,135
2020-12-21,44,48,18,0,110
2020-12-22,29,36,9,0,74
2020-12-23,40,55,19,0,114
2020-12-24,40,66,17,0,123
2020-12-25,31,47,19,0,97
2020-12-26,51,51,59,0,161
2020-12-27,32,37,16,0,85
2020-12-28,26,52,16,0,94
2020-12-29,23,35,29,0,87
2020-12-30,35,50,48,0,133
2020-12-31,54,70,43,0,167
2021-01-01,42,44,12,0,98
2021-01-02,37,28,12,0,77
2021-01-03,26,25,17,0,68
2021-01-04,32,43,18,0,93
2021-01-05,34,28,17,0,79
2021-01-06,43,46,26,0,115
2021-01-07,48,83,30,0,161
2021-01-08,77,76,28,0,181
2021-01-09,80,93,42,0,215
2021-01-10,85,64,39,0,188
2021-01-11,54,62,19,0,135
2021-01-12,66,48,31,0,145
2021-01-13,51,44,14,0,109
2021-01-14,84,77,33,0,194
2021-01-15,90,84,28,0,202
2021-01-16,84,85,23,0,192
2021-01-17,51,43,30,0,124
2021-01-18,55,50,20,0,125
2021-01-19,40,31,21,0,92
2021-01-20,63,79,22,0,164
2021-01-21,65,39,26,0,130
2021-01-22,43,46,22,0,111
2021-01-23,52,69,17,0,138
2021-01-24,42,38,14,0,94
2021-01-25,39,34,15,0,88
2021-01-26,44,39,23,0,106
2021-01-27,61,54,32,0,147
2021-01-28,40,31,44,0,115
2021-01-29,56,40,15,0,111
2021-01-30,64,33,9,0,106
2021-01-31,49,36,19,0,104
2021-02-01,38,28,10,0,76
2021-02-02,47,50,8,0,105
2021-02-03,37,38,19,0,94
2021-02-04,58,40,22,0,120
2021-02-05,34,48,11,0,93
2021-02-06,21,38,19,0,78
2021-02-07,33,23,13,0,69
2021-02-08,22,24,4,0,50
2021-02-09,17,13,11,0,41
2021-02-10,26,29,9,0,64
2021-02-11,44,41,7,0,92
2021-02-12,35,33,7,0,75
2021-02-13,20,9,10,0,39
2021-02-14,23,21,8,0,52
2021-02-15,18,15,8,0,41
2021-02-16,27,13,4,0,44
2021-02-17,33,18,13,0,64
2021-02-18,11,17,4,0,32
2021-02-19,19,18,6,0,43
2021-02-20,15,14,5,0,34
2021-02-21,18,26,19,0,63
2021-02-22,8,9,4,0,21
2021-02-23,31,21,14,0,66
2021-02-24,16,19,8,0,43
2021-02-25,16,11,16,0,43
2021-02-26,12,16,8,0,36
2021-02-27,18,16,9,0,43
2021-02-28,11,11,5,0,27
2021-03-01,10,13,6,0,29
2021-03-02,12,14,3,0,29
2021-03-03,23,25,12,0,60
2021-03-04,18,33,15,0,66
2021-03-05,26,29,9,0,64
2021-03-06,20,17,10,0,47
2021-03-07,23,48,13,0,84
2021-03-08,20,31,12,0,63
2021-03-09,18,29,16,0,63
2021-03-10,24,22,19,0,65
2021-03-11,28,26,17,0,71
2021-03-12,15,32,6,0,53
2021-03-13,27,23,8,0,58
2021-03-14,18,18,9,0,45
2021-03-15,20,19,15,0,54
2021-03-16,27,27,15,0,69
2021-03-17,38,20,15,0,73
2021-03-18,49,35,12,0,96
2021-03-19,40,22,16,0,78
2021-03-20,25,14,12,0,51
2021-03-21,22,29,9,0,60
2021-03-22,27,16,7,0,50
2021-03-23,22,12,8,0,42
2021-03-24,29,37,15,0,81
2021-03-25,37,17,13,0,67
2021-03-26,27,27,15,0,69
2021-03-27,25,27,10,0,62
2021-03-28,34,31,9,0,74
2021-03-29,20,14,12,0,46
2021-03-30,21,25,10,0,56
2021-03-31,25,35,16,0,76
2021-04-01,14,27,16,0,57
2021-04-02,24,20,13,0,57
2021-04-03,33,25,8,0,66
2021-04-04,18,24,11,0,53
2021-04-05,26,31,14,0,71
2021-04-06,21,26,16,0,63
2021-04-07,28,29,15,0,72
2021-04-08,33,32,14,0,79
2021-04-09,35,28,20,0,83
2021-04-10,48,54,14,0,116
2021-04-11,30,27,12,0,69
2021-04-12,28,23,7,0,58
2021-04-13,23,21,16,0,60
2021-04-14,41,26,10,0,77
2021-04-15,45,40,16,0,101
2021-04-16,46,38,14,0,98
2021-04-17,57,38,14,0,109
2021-04-18,45,41,12,0,98
2021-04-19,29,31,18,0,78
2021-04-20,44,41,21,0,106
2021-04-21,49,54,21,0,124
2021-04-22,54,67,32,0,153
2021-04-23,58,72,28,0,158
2021-04-24,62,68,30,0,160
2021-04-25,35,47,28,0,110
2021-04-26,43,59,37,0,139
2021-04-27,50,44,27,0,121
2021-04-28,92,78,49,0,219
2021-04-29,100,80,54,0,234
2021-04-30,75,74,38,0,187
2021-05-01,86,51,43,0,180
2021-05-02,133,135,58,0,326
2021-05-03,62,35,17,0,114
2021-05-04,98,106,29,0,233
2021-05-05,90,61,30,0,181
2021-05-06,147,125,48,0,320
2021-05-07,109,87,52,0,248
2021-05-08,190,157,56,0,403
2021-05-09,234,182,90,0,506
2021-05-10,189,145,75,0,409
2021-05-11,193,164,64,0,421
2021-05-12,204,232,93,0,529
2021-05-13,316,287,109,0,712
2021-05-14,257,229,107,0,593
2021-05-15,259,227,80,0,566
2021-05-16,190,197,104,0,491
2021-05-17,167,144,61,0,372
2021-05-18,213,233,86,1,532
2021-05-19,234,242,128,0,604
2021-05-20,282,242,157,0,681
2021-05-21,280,275,172,0,727
2021-05-22,261,267,130,0,658
2021-05-23,259,214,132,0,605
2021-05-24,130,143,93,0,366
2021-05-25,199,179,81,0,459
2021-05-26,219,223,109,0,551
2021-05-27,250,238,82,0,570
2021-05-28,170,176,77,0,423
2021-05-29,186,186,70,0,442
2021-05-30,106,134,48,0,288
2021-05-31,120,118,41,0,279
2021-06-01,107,94,53,0,254
2021-06-02,129,139,49,0,317
2021-06-03,114,142,44,0,300
2021-06-04,71,92,40,0,203
2021-06-05,89,137,50,0,276
2021-06-06,86,69,28,0,183
2021-06-07,48,73,26,0,147
2021-06-08,40,54,26,0,120
2021-06-09,68,82,29,0,179
2021-06-10,68,87,27,0,182
2021-06-11,56,56,33,0,145
2021-06-12,55,46,24,0,125
2021-06-13,31,39,12,0,82
2021-06-14,26,37,11,0,74
2021-06-15,31,34,22,0,87
2021-06-16,47,31,10,0,88
2021-06-17,31,27,15,0,73
2021-06-18,37,32,7,0,76
2021-06-19,28,33,12,0,73
2021-06-20,25,21,6,0,52
2021-06-21,16,15,6,0,37
2021-06-22,12,8,9,0,29
2021-06-23,21,23,5,0,49
2021-06-24,15,10,1,0,26
2021-06-25,17,9,7,0,33
2021-06-26,18,20,9,0,47
2021-06-27,16,10,2,0,28
2021-06-28,13,9,5,0,27
2021-06-29,10,10,3,0,23
2021-06-30,16,16,6,0,38
2021-07-01,17,18,4,0,39
2021-07-02,12,7,7,0,26
2021-07-03,14,11,5,0,30
2021-07-04,22,15,2,0,39
2021-07-05,13,11,5,0,29
2021-07-06,19,9,6,0,34
2021-07-07,35,20,12,0,67
2021-07-08,34,14,14,0,62
2021-07-09,22,21,7,0,50
2021-07-10,34,22,8,0,64
2021-07-11,25,15,16,0,56
2021-07-12,25,13,9,0,47
2021-07-13,23,21,16,0,60
2021-07-14,41,17,17,0,75
2021-07-15,21,35,29,0,85
2021-07-16,35,24,14,0,73
2021-07-17,43,44,24,0,111
2021-07-18,38,48,21,0,107
2021-07-19,38,22,10,0,70
2021-07-20,35,50,19,0,104
2021-07-21,60,36,22,0,118
2021-07-22,74,44,22,0,140
2021-07-23,31,28,20,0,79
2021-07-24,53,47,18,0,118
2021-07-25,55,32,26,0,113
2021-07-26,63,42,32,0,137
2021-07-27,65,47,26,0,138
2021-07-28,124,67,36,0,227
2021-07-29,130,88,42,0,260
2021-07-30,137,77,36,0,250
2021-07-31,145,90,49,0,284
2021-08-01,115,110,42,0,267
2021-08-02,78,92,47,0,217
2021-08-03,97,69,45,0,211
2021-08-04,171,108,87,0,366
2021-08-05,168,125,49,0,342
2021-08-06,150,100,33,0,283
2021-08-07,157,140,50,0,347
2021-08-08,153,104,51,0,308
2021-08-09,134,112,64,0,310
2021-08-10,167,106,74,0,347
2021-08-11,164,127,60,0,351
2021-08-12,221,179,80,0,480
2021-08-13,212,158,84,0,454
2021-08-14,200,191,88,0,479
2021-08-15,171,127,68,0,366
2021-08-16,145,138,74,0,357
2021-08-17,183,146,81,0,410
2021-08-18,281,210,104,0,595
2021-08-19,264,202,109,0,575
2021-08-20,234,192,97,0,523
2021-08-21,275,208,96,0,579
2021-08-22,232,211,86,0,529
2021-08-23,174,157,89,0,420
2021-08-24,198,154,74,0,426
2021-08-25,258,180,130,0,568
2021-08-26,195,197,112,0,504
2021-08-27,167,140,75,0,382
2021-08-28,195,162,100,0,457
2021-08-29,159,138,62,0,359
2021-08-30,107,93,66,0,266
2021-08-31,132,103,70,0,305
2021-09-01,145,127,79,0,351
2021-09-02,138,107,69,0,314
2021-09-03,109,95,47,0,251
2021-09-04,89,88,47,0,224
2021-09-05,88,76,54,0,218
2021-09-06,43,47,33,0,123
2021-09-07,53,46,38,0,137
2021-09-08,72,67,41,0,180
2021-09-09,69,45,30,0,144
2021-09-10,48,46,23,0,117
2021-09-11,64,58,34,0,156
2021-09-12,50,47,19,0,116
2021-09-13,23,14,18,0,55
2021-09-14,37,25,29,0,91
2021-09-15,44,30,36,0,110
2021-09-16,34,38,22,0,94
2021-09-17,40,24,20,0,84
2021-09-18,30,26,21,0,77
2021-09-19,38,22,15,0,75
2021-09-20,24,22,4,0,50
2021-09-21,15,18,3,0,36
2021-09-22,20,29,7,0,56
2021-09-23,39,31,6,0,76
2021-09-24,22,32,9,0,63
2021-09-25,26,25,12,0,63
2021-09-26,28,19,7,0,54
2021-09-27,12,5,2,0,19
2021-09-28,8,11,7,0,26
2021-09-29,17,18,10,0,45
2021-09-30,11,9,6,0,26
2021-10-01,12,16,4,0,32
2021-10-02,12,11,2,0,25
2021-10-03,3,3,3,0,9
2021-10-04,0,4,1,0,5
2021-10-05,9,3,8,0,20
2021-10-06,5,8,3,0,16
2021-10-07,7,7,0,0,14
2021-10-08,9,8,4,0,21
2021-10-09,8,9,7,0,24
2021-10-10,13,3,1,0,17
2021-10-11,6,7,3,0,16
2021-10-12,5,7,4,0,16
2021-10-13,7,8,6,0,21
2021-10-14,15,20,10,0,45
2021-10-15,6,12,9,0,27
2021-10-16,13,5,6,0,24
2021-10-17,11,16,11,0,38
2021-10-18,5,5,1,0,11
2021-10-19,4,5,3,0,12
2021-10-20,7,7,0,0,14
2021-10-21,7,0,4,0,11
2021-10-22,5,6,4,0,15
2021-10-23,2,2,1,0,5
2021-10-24,1,9,8,0,18
2021-10-25,1,0,0,0,1
2021-10-26,4,2,7,0,13
2021-10-27,1,5,3,0,9
2021-10-28,3,2,0,0,5
2021-10-29,1,3,4,0,8
2021-10-30,5,1,2,0,8
2021-10-31,4,3,4,0,11
2021-11-01,2,1,0,0,3
2021-11-02,7,2,5,0,14
2021-11-03,4,3,6,0,13
2021-11-04,2,1,1,0,4
2021-11-05,3,5,5,0,13
2021-11-06,7,3,3,0,13
2021-11-07,5,3,2,0,10
2021-11-08,4,1,1,0,6
2021-11-09,6,2,5,0,13
2021-11-10,1,1,6,0,8
2021-11-11,4,2,2,0,8
2021-11-12,12,4,6,0,22
2021-11-13,7,3,9,0,19
2021-11-14,6,3,0,0,9
