code,prefecture,total,first,second,category,date
1,北海道,92179,56808,35371,medical,20210419
2,青森県,20804,13239,7565,medical,20210419
3,岩手県,21526,12800,8726,medical,20210419
4,宮城県,35223,20463,14760,medical,20210419
5,秋田県,18940,11795,7145,medical,20210419
6,山形県,21482,13314,8168,medical,20210419
7,福島県,29418,18322,11096,medical,20210419
8,茨城県,43555,26364,17191,medical,20210419
9,栃木県,29761,17766,11995,medical,20210419
10,群馬県,31335,19586,11749,medical,20210419
11,埼玉県,81737,52044,29693,medical,20210419
12,千葉県,81731,49198,32533,medical,20210419
13,東京都,180851,117683,63168,medical,20210419
14,神奈川県,79262,50264,28998,medical,20210419
15,新潟県,33968,22757,11211,medical,20210419
16,富山県,20366,12278,8088,medical,20210419
17,石川県,18145,12267,5878,medical,20210419
18,福井県,13489,8172,5317,medical,20210419
19,山梨県,12759,7423,5336,medical,20210419
20,長野県,30890,20499,10391,medical,20210419
21,岐阜県,29633,19189,10444,medical,20210419
22,静岡県,43978,28524,15454,medical,20210419
23,愛知県,85741,56349,29392,medical,20210419
24,三重県,30298,18255,12043,medical,20210419
25,滋賀県,19998,12071,7927,medical,20210419
26,京都府,40348,25009,15339,medical,20210419
27,大阪府,131985,83193,48792,medical,20210419
28,兵庫県,75640,51262,24378,medical,20210419
29,奈良県,20287,11527,8760,medical,20210419
30,和歌山県,18349,11670,6679,medical,20210419
31,鳥取県,13678,7429,6249,medical,20210419
32,島根県,12571,7602,4969,medical,20210419
33,岡山県,32155,19447,12708,medical,20210419
34,広島県,47473,29083,18390,medical,20210419
35,山口県,35727,20539,15188,medical,20210419
36,徳島県,16888,9715,7173,medical,20210419
37,香川県,19429,13091,6338,medical,20210419
38,愛媛県,24230,14468,9762,medical,20210419
39,高知県,19242,12400,6842,medical,20210419
40,福岡県,81024,49874,31150,medical,20210419
41,佐賀県,24657,14437,10220,medical,20210419
42,長崎県,32861,20861,12000,medical,20210419
43,熊本県,45546,27955,17591,medical,20210419
44,大分県,26008,15035,10973,medical,20210419
45,宮崎県,24463,14957,9506,medical,20210419
46,鹿児島県,36447,21689,14758,medical,20210419
47,沖縄県,30665,19673,10992,medical,20210419
1,北海道,272,272,0,elderly,20210419
2,青森県,1017,1017,0,elderly,20210419
3,岩手県,352,352,0,elderly,20210419
4,宮城県,53,53,0,elderly,20210419
5,秋田県,407,407,0,elderly,20210419
6,山形県,382,382,0,elderly,20210419
7,福島県,598,598,0,elderly,20210419
8,茨城県,53,53,0,elderly,20210419
9,栃木県,0,0,0,elderly,20210419
10,群馬県,136,136,0,elderly,20210419
11,埼玉県,0,0,0,elderly,20210419
12,千葉県,32,32,0,elderly,20210419
13,東京都,945,945,0,elderly,20210419
14,神奈川県,1028,1028,0,elderly,20210419
15,新潟県,388,388,0,elderly,20210419
16,富山県,5,5,0,elderly,20210419
17,石川県,1049,1049,0,elderly,20210419
18,福井県,404,404,0,elderly,20210419
19,山梨県,328,328,0,elderly,20210419
20,長野県,140,140,0,elderly,20210419
21,岐阜県,185,185,0,elderly,20210419
22,静岡県,0,0,0,elderly,20210419
23,愛知県,1190,1190,0,elderly,20210419
24,三重県,2,2,0,elderly,20210419
25,滋賀県,0,0,0,elderly,20210419
26,京都府,93,93,0,elderly,20210419
27,大阪府,347,347,0,elderly,20210419
28,兵庫県,0,0,0,elderly,20210419
29,奈良県,215,215,0,elderly,20210419
30,和歌山県,427,427,0,elderly,20210419
31,鳥取県,72,72,0,elderly,20210419
32,島根県,0,0,0,elderly,20210419
33,岡山県,129,129,0,elderly,20210419
34,広島県,231,231,0,elderly,20210419
35,山口県,607,607,0,elderly,20210419
36,徳島県,21,21,0,elderly,20210419
37,香川県,961,961,0,elderly,20210419
38,愛媛県,92,92,0,elderly,20210419
39,高知県,68,68,0,elderly,20210419
40,福岡県,16,16,0,elderly,20210419
41,佐賀県,0,0,0,elderly,20210419
42,長崎県,89,89,0,elderly,20210419
43,熊本県,0,0,0,elderly,20210419
44,大分県,0,0,0,elderly,20210419
45,宮崎県,433,433,0,elderly,20210419
46,鹿児島県,487,487,0,elderly,20210419
47,沖縄県,115,115,0,elderly,20210419
1,北海道,115865,72190,43675,medical,20210423
2,青森県,28342,18443,9899,medical,20210423
3,岩手県,31075,21793,9282,medical,20210423
4,宮城県,49963,33082,16881,medical,20210423
5,秋田県,26504,18213,8291,medical,20210423
6,山形県,27064,17544,9520,medical,20210423
7,福島県,38028,24287,13741,medical,20210423
8,茨城県,60710,40370,20340,medical,20210423
9,栃木県,42832,28116,14716,medical,20210423
10,群馬県,44061,28812,15249,medical,20210423
11,埼玉県,123188,85296,37892,medical,20210423
12,千葉県,107186,70266,36920,medical,20210423
13,東京都,254513,173280,81233,medical,20210423
14,神奈川県,113758,79039,34719,medical,20210423
15,新潟県,49750,35419,14331,medical,20210423
16,富山県,27404,18351,9053,medical,20210423
17,石川県,29954,20988,8966,medical,20210423
18,福井県,21361,15162,6199,medical,20210423
19,山梨県,15452,9229,6223,medical,20210423
20,長野県,43353,30323,13030,medical,20210423
21,岐阜県,44492,30334,14158,medical,20210423
22,静岡県,64995,43626,21369,medical,20210423
23,愛知県,137063,99994,37069,medical,20210423
24,三重県,41143,28421,12722,medical,20210423
25,滋賀県,28301,18440,9861,medical,20210423
26,京都府,52706,35096,17610,medical,20210423
27,大阪府,166230,105584,60646,medical,20210423
28,兵庫県,97906,67822,30084,medical,20210423
29,奈良県,26943,17507,9436,medical,20210423
30,和歌山県,27047,18367,8680,medical,20210423
31,鳥取県,18161,11523,6638,medical,20210423
32,島根県,18176,12180,5996,medical,20210423
33,岡山県,44632,30699,13933,medical,20210423
34,広島県,67332,46109,21223,medical,20210423
35,山口県,42646,25814,16832,medical,20210423
36,徳島県,25013,17125,7888,medical,20210423
37,香川県,25506,17431,8075,medical,20210423
38,愛媛県,36135,24625,11510,medical,20210423
39,高知県,26527,16818,9709,medical,20210423
40,福岡県,109424,65686,43738,medical,20210423
41,佐賀県,31726,21354,10372,medical,20210423
42,長崎県,43332,28099,15233,medical,20210423
43,熊本県,56336,35782,20554,medical,20210423
44,大分県,36718,24933,11785,medical,20210423
45,宮崎県,33854,21896,11958,medical,20210423
46,鹿児島県,50896,33865,17031,medical,20210423
47,沖縄県,39635,25171,14464,medical,20210423
1,北海道,1004,1004,0,elderly,20210425
2,青森県,2211,2211,0,elderly,20210425
3,岩手県,1992,1992,0,elderly,20210425
4,宮城県,458,458,0,elderly,20210425
5,秋田県,1889,1889,0,elderly,20210425
6,山形県,2262,2262,0,elderly,20210425
7,福島県,2007,2007,0,elderly,20210425
8,茨城県,289,289,0,elderly,20210425
9,栃木県,488,488,0,elderly,20210425
10,群馬県,2044,2044,0,elderly,20210425
11,埼玉県,556,556,0,elderly,20210425
12,千葉県,595,595,0,elderly,20210425
13,東京都,2899,2899,0,elderly,20210425
14,神奈川県,3602,3602,0,elderly,20210425
15,新潟県,2245,2245,0,elderly,20210425
16,富山県,647,647,0,elderly,20210425
17,石川県,3975,3975,0,elderly,20210425
18,福井県,1489,1489,0,elderly,20210425
19,山梨県,2161,2161,0,elderly,20210425
20,長野県,1564,1564,0,elderly,20210425
21,岐阜県,1629,1629,0,elderly,20210425
22,静岡県,407,407,0,elderly,20210425
23,愛知県,2171,2171,0,elderly,20210425
24,三重県,798,798,0,elderly,20210425
25,滋賀県,1229,1229,0,elderly,20210425
26,京都府,741,741,0,elderly,20210425
27,大阪府,2460,2460,0,elderly,20210425
28,兵庫県,1457,1457,0,elderly,20210425
29,奈良県,1321,1321,0,elderly,20210425
30,和歌山県,3049,3049,0,elderly,20210425
31,鳥取県,2180,2180,0,elderly,20210425
32,島根県,819,819,0,elderly,20210425
33,岡山県,727,727,0,elderly,20210425
34,広島県,2238,2238,0,elderly,20210425
35,山口県,2935,2935,0,elderly,20210425
36,徳島県,1014,1014,0,elderly,20210425
37,香川県,2147,2147,0,elderly,20210425
38,愛媛県,993,993,0,elderly,20210425
39,高知県,916,916,0,elderly,20210425
40,福岡県,1169,1169,0,elderly,20210425
41,佐賀県,1685,1685,0,elderly,20210425
42,長崎県,2206,2206,0,elderly,20210425
43,熊本県,1095,1095,0,elderly,20210425
44,大分県,1567,1567,0,elderly,20210425
45,宮崎県,1682,1682,0,elderly,20210425
46,鹿児島県,1189,1189,0,elderly,20210425
47,沖縄県,651,651,0,elderly,20210425
1,北海道,146108,95871,50237,medical,20210430
2,青森県,38446,26937,11509,medical,20210430
3,岩手県,40626,30022,10604,medical,20210430
4,宮城県,67146,48260,18886,medical,20210430
5,秋田県,34690,23819,10871,medical,20210430
6,山形県,37972,26320,11652,medical,20210430
7,福島県,55617,38649,16968,medical,20210430
8,茨城県,81667,57446,24221,medical,20210430
9,栃木県,57615,40441,17174,medical,20210430
10,群馬県,60811,43152,17659,medical,20210430
11,埼玉県,170056,122806,47250,medical,20210430
12,千葉県,145235,102528,42707,medical,20210430
13,東京都,354005,251192,102813,medical,20210430
14,神奈川県,175653,135263,40390,medical,20210430
15,新潟県,68353,50097,18256,medical,20210430
16,富山県,38623,28104,10519,medical,20210430
17,石川県,39828,29327,10501,medical,20210430
18,福井県,33003,25871,7132,medical,20210430
19,山梨県,22289,14809,7480,medical,20210430
20,長野県,58608,42792,15816,medical,20210430
21,岐阜県,60141,42162,17979,medical,20210430
22,静岡県,96084,70574,25510,medical,20210430
23,愛知県,201384,155262,46122,medical,20210430
24,三重県,54231,39872,14359,medical,20210430
25,滋賀県,37541,27262,10279,medical,20210430
26,京都府,73992,54241,19751,medical,20210430
27,大阪府,210867,138627,72240,medical,20210430
28,兵庫県,121569,85999,35570,medical,20210430
29,奈良県,41758,31447,10311,medical,20210430
30,和歌山県,37003,26207,10796,medical,20210430
31,鳥取県,24532,17517,7015,medical,20210430
32,島根県,24806,17773,7033,medical,20210430
33,岡山県,62681,46026,16655,medical,20210430
34,広島県,94828,69739,25089,medical,20210430
35,山口県,61256,42490,18766,medical,20210430
36,徳島県,35390,26533,8857,medical,20210430
37,香川県,34222,23436,10786,medical,20210430
38,愛媛県,54275,40769,13506,medical,20210430
39,高知県,34602,22888,11714,medical,20210430
40,福岡県,145918,96417,49501,medical,20210430
41,佐賀県,42354,30237,12117,medical,20210430
42,長崎県,58996,40013,18983,medical,20210430
43,熊本県,78449,53481,24968,medical,20210430
44,大分県,48373,35436,12937,medical,20210430
45,宮崎県,43760,29929,13831,medical,20210430
46,鹿児島県,66586,48427,18159,medical,20210430
47,沖縄県,50971,33452,17519,medical,20210430
1,北海道,4277,4277,0,elderly,20210505
2,青森県,4345,4345,0,elderly,20210505
3,岩手県,4906,4906,0,elderly,20210505
4,宮城県,2934,2934,0,elderly,20210505
5,秋田県,5227,5227,0,elderly,20210505
6,山形県,7509,7509,0,elderly,20210505
7,福島県,5365,5365,0,elderly,20210505
8,茨城県,3146,3146,0,elderly,20210505
9,栃木県,2618,2618,0,elderly,20210505
10,群馬県,4131,4131,0,elderly,20210505
11,埼玉県,2544,2544,0,elderly,20210505
12,千葉県,3596,3596,0,elderly,20210505
13,東京都,7753,7753,0,elderly,20210505
14,神奈川県,7967,7967,0,elderly,20210505
15,新潟県,5249,5249,0,elderly,20210505
16,富山県,1396,1396,0,elderly,20210505
17,石川県,6469,6469,0,elderly,20210505
18,福井県,4187,4187,0,elderly,20210505
19,山梨県,3045,3045,0,elderly,20210505
20,長野県,3200,3200,0,elderly,20210505
21,岐阜県,4819,4819,0,elderly,20210505
22,静岡県,2963,2963,0,elderly,20210505
23,愛知県,6405,6405,0,elderly,20210505
24,三重県,2596,2596,0,elderly,20210505
25,滋賀県,4658,4658,0,elderly,20210505
26,京都府,1785,1785,0,elderly,20210505
27,大阪府,9789,9789,0,elderly,20210505
28,兵庫県,4474,4474,0,elderly,20210505
29,奈良県,3659,3659,0,elderly,20210505
30,和歌山県,7449,7449,0,elderly,20210505
31,鳥取県,4641,4641,0,elderly,20210505
32,島根県,2989,2989,0,elderly,20210505
33,岡山県,1746,1746,0,elderly,20210505
34,広島県,7786,7786,0,elderly,20210505
35,山口県,6088,6088,0,elderly,20210505
36,徳島県,3884,3884,0,elderly,20210505
37,香川県,6524,6524,0,elderly,20210505
38,愛媛県,2447,2447,0,elderly,20210505
39,高知県,4177,4177,0,elderly,20210505
40,福岡県,4408,4408,0,elderly,20210505
41,佐賀県,4060,4060,0,elderly,20210505
42,長崎県,5088,5088,0,elderly,20210505
43,熊本県,4883,4883,0,elderly,20210505
44,大分県,4047,4047,0,elderly,20210505
45,宮崎県,4956,4956,0,elderly,20210505
46,鹿児島県,5390,5390,0,elderly,20210505
47,沖縄県,2350,2350,0,elderly,20210505
1,北海道,164622,110357,54265,medical,20210507
2,青森県,43071,30210,12861,medical,20210507
3,岩手県,49643,37849,11794,medical,20210507
4,宮城県,74061,54120,19941,medical,20210507
5,秋田県,36793,24963,11830,medical,20210507
6,山形県,43627,30693,12934,medical,20210507
7,福島県,64642,46232,18410,medical,20210507
8,茨城県,91573,65786,25787,medical,20210507
9,栃木県,63575,45934,17641,medical,20210507
10,群馬県,66539,47455,19084,medical,20210507
11,埼玉県,196355,144470,51885,medical,20210507
12,千葉県,160846,115257,45589,medical,20210507
13,東京都,404983,290463,114520,medical,20210507
14,神奈川県,215694,167971,47723,medical,20210507
15,新潟県,76670,56252,20418,medical,20210507
16,富山県,42755,30794,11961,medical,20210507
17,石川県,44400,33285,11115,medical,20210507
18,福井県,36859,28972,7887,medical,20210507
19,山梨県,24275,16466,7809,medical,20210507
20,長野県,67184,49713,17471,medical,20210507
21,岐阜県,65328,46302,19026,medical,20210507
22,静岡県,106529,79212,27317,medical,20210507
23,愛知県,232493,178287,54206,medical,20210507
24,三重県,62321,45350,16971,medical,20210507
25,滋賀県,47662,35145,12517,medical,20210507
26,京都府,85754,62704,23050,medical,20210507
27,大阪府,233690,155198,78492,medical,20210507
28,兵庫県,149956,104267,45689,medical,20210507
29,奈良県,47112,35925,11187,medical,20210507
30,和歌山県,40201,28574,11627,medical,20210507
31,鳥取県,25037,17980,7057,medical,20210507
32,島根県,28004,20664,7340,medical,20210507
33,岡山県,68993,51696,17297,medical,20210507
34,広島県,103296,76197,27099,medical,20210507
35,山口県,65528,45438,20090,medical,20210507
36,徳島県,39017,29576,9441,medical,20210507
37,香川県,38654,26037,12617,medical,20210507
38,愛媛県,60266,45291,14975,medical,20210507
39,高知県,37115,24006,13109,medical,20210507
40,福岡県,162636,109771,52865,medical,20210507
41,佐賀県,46287,32839,13448,medical,20210507
42,長崎県,65212,44904,20308,medical,20210507
43,熊本県,87289,60846,26443,medical,20210507
44,大分県,52455,38970,13485,medical,20210507
45,宮崎県,47239,32851,14388,medical,20210507
46,鹿児島県,73668,54420,19248,medical,20210507
47,沖縄県,55269,36373,18896,medical,20210507
1,北海道,7861,7819,42,elderly,20210509
2,青森県,6025,5813,212,elderly,20210509
3,岩手県,6690,6384,306,elderly,20210509
4,宮城県,4726,4714,12,elderly,20210509
5,秋田県,7585,7487,98,elderly,20210509
6,山形県,12334,11957,377,elderly,20210509
7,福島県,10227,10136,91,elderly,20210509
8,茨城県,6177,6134,43,elderly,20210509
9,栃木県,5688,5687,1,elderly,20210509
10,群馬県,5212,5170,42,elderly,20210509
11,埼玉県,7366,7260,106,elderly,20210509
12,千葉県,5678,5642,36,elderly,20210509
13,東京都,20869,20650,219,elderly,20210509
14,神奈川県,10041,9121,920,elderly,20210509
15,新潟県,8213,7899,314,elderly,20210509
16,富山県,1471,1424,47,elderly,20210509
17,石川県,10414,9378,1036,elderly,20210509
18,福井県,5434,5240,194,elderly,20210509
19,山梨県,4994,4662,332,elderly,20210509
20,長野県,6563,6406,157,elderly,20210509
21,岐阜県,6923,6717,206,elderly,20210509
22,静岡県,5209,5170,39,elderly,20210509
23,愛知県,12536,11570,966,elderly,20210509
24,三重県,3745,3744,1,elderly,20210509
25,滋賀県,8991,8991,0,elderly,20210509
26,京都府,2190,2121,69,elderly,20210509
27,大阪府,15439,15270,169,elderly,20210509
28,兵庫県,9199,9100,99,elderly,20210509
29,奈良県,5401,5290,111,elderly,20210509
30,和歌山県,12174,11757,417,elderly,20210509
31,鳥取県,6618,6599,19,elderly,20210509
32,島根県,4006,3969,37,elderly,20210509
33,岡山県,2493,2367,126,elderly,20210509
34,広島県,9856,9158,698,elderly,20210509
35,山口県,7646,7138,508,elderly,20210509
36,徳島県,4981,4980,1,elderly,20210509
37,香川県,9031,8634,397,elderly,20210509
38,愛媛県,3050,3032,18,elderly,20210509
39,高知県,6587,6470,117,elderly,20210509
40,福岡県,7529,7520,9,elderly,20210509
41,佐賀県,5369,5368,1,elderly,20210509
42,長崎県,6705,6705,0,elderly,20210509
43,熊本県,7888,7887,1,elderly,20210509
44,大分県,4965,4965,0,elderly,20210509
45,宮崎県,6643,6344,299,elderly,20210509
46,鹿児島県,8580,8159,421,elderly,20210509
47,沖縄県,3825,3813,12,elderly,20210509
1,北海道,209822,140506,69316,medical,20210514
2,青森県,51928,34493,17435,medical,20210514
3,岩手県,62669,42443,20226,medical,20210514
4,宮城県,93823,64322,29501,medical,20210514
5,秋田県,45381,27721,17660,medical,20210514
6,山形県,51586,34560,17026,medical,20210514
7,福島県,79585,56155,23430,medical,20210514
8,茨城県,114919,77803,37116,medical,20210514
9,栃木県,78403,51716,26687,medical,20210514
10,群馬県,81215,54321,26894,medical,20210514
11,埼玉県,255912,173714,82198,medical,20210514
12,千葉県,202614,136902,65712,medical,20210514
13,東京都,498522,338771,159751,medical,20210514
14,神奈川県,279985,206880,73105,medical,20210514
15,新潟県,94999,62075,32924,medical,20210514
16,富山県,52079,33970,18109,medical,20210514
17,石川県,57008,36959,20049,medical,20210514
18,福井県,47698,33311,14387,medical,20210514
19,山梨県,29310,20519,8791,medical,20210514
20,長野県,86514,57947,28567,medical,20210514
21,岐阜県,85321,55088,30233,medical,20210514
22,静岡県,132562,93567,38995,medical,20210514
23,愛知県,297030,205364,91666,medical,20210514
24,三重県,81601,53575,28026,medical,20210514
25,滋賀県,56686,38688,17998,medical,20210514
26,京都府,103673,69143,34530,medical,20210514
27,大阪府,303189,201181,102008,medical,20210514
28,兵庫県,184990,122394,62596,medical,20210514
29,奈良県,61471,43549,17922,medical,20210514
30,和歌山県,49393,31665,17728,medical,20210514
31,鳥取県,30767,19833,10934,medical,20210514
32,島根県,35045,24374,10671,medical,20210514
33,岡山県,90758,64248,26510,medical,20210514
34,広島県,129875,87198,42677,medical,20210514
35,山口県,77621,52128,25493,medical,20210514
36,徳島県,49262,33161,16101,medical,20210514
37,香川県,45931,29299,16632,medical,20210514
38,愛媛県,74698,49689,25009,medical,20210514
39,高知県,45924,28322,17602,medical,20210514
40,福岡県,202228,138038,64190,medical,20210514
41,佐賀県,57046,36610,20436,medical,20210514
42,長崎県,77636,50884,26752,medical,20210514
43,熊本県,103815,71014,32801,medical,20210514
44,大分県,66567,43704,22863,medical,20210514
45,宮崎県,56057,35780,20277,medical,20210514
46,鹿児島県,91335,61409,29926,medical,20210514
47,沖縄県,66704,42495,24209,medical,20210514
1,北海道,28860,27725,1135,elderly,20210516
2,青森県,16303,14667,1636,elderly,20210516
3,岩手県,15658,13749,1909,elderly,20210516
4,宮城県,16459,16203,256,elderly,20210516
5,秋田県,19622,18229,1393,elderly,20210516
6,山形県,22881,20408,2473,elderly,20210516
7,福島県,22831,22023,808,elderly,20210516
8,茨城県,18825,18547,278,elderly,20210516
9,栃木県,14102,13728,374,elderly,20210516
10,群馬県,18385,16846,1539,elderly,20210516
11,埼玉県,29226,28389,837,elderly,20210516
12,千葉県,25986,25425,561,elderly,20210516
13,東京都,74841,72080,2761,elderly,20210516
14,神奈川県,32672,28913,3759,elderly,20210516
15,新潟県,23874,21668,2206,elderly,20210516
16,富山県,3646,2966,680,elderly,20210516
17,石川県,20847,17447,3400,elderly,20210516
18,福井県,11003,9788,1215,elderly,20210516
19,山梨県,10883,9260,1623,elderly,20210516
20,長野県,23749,22248,1501,elderly,20210516
21,岐阜県,20143,18954,1189,elderly,20210516
22,静岡県,18246,17722,524,elderly,20210516
23,愛知県,57405,55296,2109,elderly,20210516
24,三重県,12264,11582,682,elderly,20210516
25,滋賀県,19336,18598,738,elderly,20210516
26,京都府,12380,11696,684,elderly,20210516
27,大阪府,43549,40943,2606,elderly,20210516
28,兵庫県,25217,23688,1529,elderly,20210516
29,奈良県,13725,12575,1150,elderly,20210516
30,和歌山県,32088,29270,2818,elderly,20210516
31,鳥取県,12874,11010,1864,elderly,20210516
32,島根県,9694,8891,803,elderly,20210516
33,岡山県,7204,6330,874,elderly,20210516
34,広島県,21396,18818,2578,elderly,20210516
35,山口県,33131,30540,2591,elderly,20210516
36,徳島県,11298,10379,919,elderly,20210516
37,香川県,17414,15070,2344,elderly,20210516
38,愛媛県,7475,7052,423,elderly,20210516
39,高知県,21852,20721,1131,elderly,20210516
40,福岡県,21929,20087,1842,elderly,20210516
41,佐賀県,14126,12680,1446,elderly,20210516
42,長崎県,12265,10969,1296,elderly,20210516
43,熊本県,17603,16908,695,elderly,20210516
44,大分県,13857,12343,1514,elderly,20210516
45,宮崎県,19253,17744,1509,elderly,20210516
46,鹿児島県,22161,21077,1084,elderly,20210516
47,沖縄県,12711,11993,718,elderly,20210516
1,北海道,266698,174981,91717,medical,20210521
2,青森県,66790,40638,26152,medical,20210521
3,岩手県,77013,46590,30423,medical,20210521
4,宮城県,120307,75248,45059,medical,20210521
5,秋田県,55608,31983,23625,medical,20210521
6,山形県,63341,38741,24600,medical,20210521
7,福島県,98596,62448,36148,medical,20210521
8,茨城県,146926,92277,54649,medical,20210521
9,栃木県,96906,58072,38834,medical,20210521
10,群馬県,102904,63057,39847,medical,20210521
11,埼玉県,321138,197042,124096,medical,20210521
12,千葉県,257328,160839,96489,medical,20210521
13,東京都,631930,386025,245905,medical,20210521
14,神奈川県,361283,229503,131780,medical,20210521
15,新潟県,115754,66971,48783,medical,20210521
16,富山県,64935,38495,26440,medical,20210521
17,石川県,71619,41724,29895,medical,20210521
18,福井県,60354,36322,24032,medical,20210521
19,山梨県,41628,26774,14854,medical,20210521
20,長野県,107948,65573,42375,medical,20210521
21,岐阜県,108707,67526,41181,medical,20210521
22,静岡県,166156,104286,61870,medical,20210521
23,愛知県,370613,226345,144268,medical,20210521
24,三重県,98674,59471,39203,medical,20210521
25,滋賀県,71126,42724,28402,medical,20210521
26,京都府,133450,80917,52533,medical,20210521
27,大阪府,370588,232809,137779,medical,20210521
28,兵庫県,233097,149314,83783,medical,20210521
29,奈良県,76903,48009,28894,medical,20210521
30,和歌山県,60009,35328,24681,medical,20210521
31,鳥取県,33960,19495,14465,medical,20210521
32,島根県,45369,27862,17507,medical,20210521
33,岡山県,114049,72730,41319,medical,20210521
34,広島県,164780,99244,65536,medical,20210521
35,山口県,98275,59625,38650,medical,20210521
36,徳島県,63095,37554,25541,medical,20210521
37,香川県,56359,33520,22839,medical,20210521
38,愛媛県,96821,55591,41230,medical,20210521
39,高知県,52787,30463,22324,medical,20210521
40,福岡県,256482,165794,90688,medical,20210521
41,佐賀県,70249,41439,28810,medical,20210521
42,長崎県,96251,57758,38493,medical,20210521
43,熊本県,124767,78330,46437,medical,20210521
44,大分県,81850,47980,33870,medical,20210521
45,宮崎県,68087,39725,28362,medical,20210521
46,鹿児島県,117499,70529,46970,medical,20210521
47,沖縄県,79378,47740,31638,medical,20210521
1,北海道,77032,73824,3208,elderly,20210523
2,青森県,35397,31860,3537,elderly,20210523
3,岩手県,31730,27629,4101,elderly,20210523
4,宮城県,34682,32084,2598,elderly,20210523
5,秋田県,39375,35151,4224,elderly,20210523
6,山形県,42135,36204,5931,elderly,20210523
7,福島県,50468,47289,3179,elderly,20210523
8,茨城県,40594,39534,1060,elderly,20210523
9,栃木県,26648,24309,2339,elderly,20210523
10,群馬県,43659,40045,3614,elderly,20210523
11,埼玉県,87843,86265,1578,elderly,20210523
12,千葉県,77135,73865,3270,elderly,20210523
13,東京都,211969,206207,5762,elderly,20210523
14,神奈川県,114365,107005,7360,elderly,20210523
15,新潟県,50811,46739,4072,elderly,20210523
16,富山県,16537,15187,1350,elderly,20210523
17,石川県,41479,35283,6196,elderly,20210523
18,福井県,24133,20716,3417,elderly,20210523
19,山梨県,19192,16006,3186,elderly,20210523
20,長野県,49169,45534,3635,elderly,20210523
21,岐阜県,43470,39731,3739,elderly,20210523
22,静岡県,51012,48942,2070,elderly,20210523
23,愛知県,118896,113463,5433,elderly,20210523
24,三重県,26415,24552,1863,elderly,20210523
25,滋賀県,37002,34011,2991,elderly,20210523
26,京都府,49415,47354,2061,elderly,20210523
27,大阪府,115756,108816,6940,elderly,20210523
28,兵庫県,76811,72782,4029,elderly,20210523
29,奈良県,24181,21537,2644,elderly,20210523
30,和歌山県,62030,53976,8054,elderly,20210523
31,鳥取県,24468,20196,4272,elderly,20210523
32,島根県,17454,14803,2651,elderly,20210523
33,岡山県,46152,43884,2268,elderly,20210523
34,広島県,46554,40322,6232,elderly,20210523
35,山口県,72126,66402,5724,elderly,20210523
36,徳島県,22282,19318,2964,elderly,20210523
37,香川県,31338,25644,5694,elderly,20210523
38,愛媛県,15468,13933,1535,elderly,20210523
39,高知県,32500,29580,2920,elderly,20210523
40,福岡県,73442,70888,2554,elderly,20210523
41,佐賀県,29319,26519,2800,elderly,20210523
42,長崎県,23024,19903,3121,elderly,20210523
43,熊本県,38347,35128,3219,elderly,20210523
44,大分県,30075,26321,3754,elderly,20210523
45,宮崎県,43108,38662,4446,elderly,20210523
46,鹿児島県,48265,44578,3687,elderly,20210523
47,沖縄県,26576,24259,2317,elderly,20210523
1,北海道,313254,206716,106538,medical,20210528
2,青森県,76307,47256,29051,medical,20210528
3,岩手県,88131,50604,37527,medical,20210528
4,宮城県,135983,83554,52429,medical,20210528
5,秋田県,61725,37115,24610,medical,20210528
6,山形県,76158,44796,31362,medical,20210528
7,福島県,116110,69717,46393,medical,20210528
8,茨城県,168252,103831,64421,medical,20210528
9,栃木県,107616,63455,44161,medical,20210528
10,群馬県,119790,73969,45821,medical,20210528
11,埼玉県,364485,217373,147112,medical,20210528
12,千葉県,295847,182851,112996,medical,20210528
13,東京都,737513,439082,298431,medical,20210528
14,神奈川県,428484,258774,169710,medical,20210528
15,新潟県,128275,74293,53982,medical,20210528
16,富山県,73119,43375,29744,medical,20210528
17,石川県,79148,46070,33078,medical,20210528
18,福井県,66285,37429,28856,medical,20210528
19,山梨県,46767,29958,16809,medical,20210528
20,長野県,119998,72223,47775,medical,20210528
21,岐阜県,125702,78639,47063,medical,20210528
22,静岡県,182267,111745,70522,medical,20210528
23,愛知県,416914,245761,171153,medical,20210528
24,三重県,110218,65128,45090,medical,20210528
25,滋賀県,78779,46622,32157,medical,20210528
26,京都府,152986,91588,61398,medical,20210528
27,大阪府,418547,261035,157512,medical,20210528
28,兵庫県,263532,164233,99299,medical,20210528
29,奈良県,92181,54540,37641,medical,20210528
30,和歌山県,68056,39834,28222,medical,20210528
31,鳥取県,35878,20393,15485,medical,20210528
32,島根県,50968,31669,19299,medical,20210528
33,岡山県,131821,84431,47390,medical,20210528
34,広島県,184372,110281,74091,medical,20210528
35,山口県,116127,66468,49659,medical,20210528
36,徳島県,69163,39894,29269,medical,20210528
37,香川県,66027,39215,26812,medical,20210528
38,愛媛県,108831,62309,46522,medical,20210528
39,高知県,59009,33314,25695,medical,20210528
40,福岡県,316496,204875,111621,medical,20210528
41,佐賀県,78401,46010,32391,medical,20210528
42,長崎県,108142,63593,44549,medical,20210528
43,熊本県,138813,85298,53515,medical,20210528
44,大分県,92633,53021,39612,medical,20210528
45,宮崎県,76858,45941,30917,medical,20210528
46,鹿児島県,128823,76134,52689,medical,20210528
47,沖縄県,86091,50762,35329,medical,20210528
1,北海道,159772,153300,6472,elderly,20210530
2,青森県,71899,65360,6539,elderly,20210530
3,岩手県,57270,51143,6127,elderly,20210530
4,宮城県,85942,80549,5393,elderly,20210530
5,秋田県,64102,56878,7224,elderly,20210530
6,山形県,76427,64859,11568,elderly,20210530
7,福島県,117741,107461,10280,elderly,20210530
8,茨城県,91335,86824,4511,elderly,20210530
9,栃木県,53183,49004,4179,elderly,20210530
10,群馬県,88733,83063,5670,elderly,20210530
11,埼玉県,217007,210527,6480,elderly,20210530
12,千葉県,195657,188929,6728,elderly,20210530
13,東京都,491790,474487,17303,elderly,20210530
14,神奈川県,232487,223193,9294,elderly,20210530
15,新潟県,106489,99019,7470,elderly,20210530
16,富山県,43191,41305,1886,elderly,20210530
17,石川県,75243,66261,8982,elderly,20210530
18,福井県,46319,41095,5224,elderly,20210530
19,山梨県,36042,31752,4290,elderly,20210530
20,長野県,96167,88108,8059,elderly,20210530
21,岐阜県,101777,95506,6271,elderly,20210530
22,静岡県,114538,110260,4278,elderly,20210530
23,愛知県,288226,276537,11689,elderly,20210530
24,三重県,44789,41414,3375,elderly,20210530
25,滋賀県,63064,57638,5426,elderly,20210530
26,京都府,117876,114859,3017,elderly,20210530
27,大阪府,292376,275758,16618,elderly,20210530
28,兵庫県,160582,150640,9942,elderly,20210530
29,奈良県,50154,46056,4098,elderly,20210530
30,和歌山県,95086,82842,12244,elderly,20210530
31,鳥取県,46337,39814,6523,elderly,20210530
32,島根県,35118,30834,4284,elderly,20210530
33,岡山県,114956,111048,3908,elderly,20210530
34,広島県,98113,88337,9776,elderly,20210530
35,山口県,121114,114017,7097,elderly,20210530
36,徳島県,40125,35639,4486,elderly,20210530
37,香川県,52372,43496,8876,elderly,20210530
38,愛媛県,46755,43033,3722,elderly,20210530
39,高知県,60156,55144,5012,elderly,20210530
40,福岡県,182831,177298,5533,elderly,20210530
41,佐賀県,59346,55072,4274,elderly,20210530
42,長崎県,50277,43273,7004,elderly,20210530
43,熊本県,72923,66508,6415,elderly,20210530
44,大分県,57297,51392,5905,elderly,20210530
45,宮崎県,79999,73604,6395,elderly,20210530
46,鹿児島県,80654,73791,6863,elderly,20210530
47,沖縄県,49071,44463,4608,elderly,20210530
1,北海道,364565,230646,133919,medical,20210604
2,青森県,86880,52994,33886,medical,20210604
3,岩手県,94839,52630,42209,medical,20210604
4,宮城県,154836,91100,63736,medical,20210604
5,秋田県,69039,40879,28160,medical,20210604
6,山形県,84845,48395,36450,medical,20210604
7,福島県,135974,77667,58307,medical,20210604
8,茨城県,188070,112541,75529,medical,20210604
9,栃木県,120110,67783,52327,medical,20210604
10,群馬県,133371,80590,52781,medical,20210604
11,埼玉県,407058,234491,172567,medical,20210604
12,千葉県,334840,202019,132821,medical,20210604
13,東京都,814955,469872,345083,medical,20210604
14,神奈川県,492038,288694,203344,medical,20210604
15,新潟県,141160,81818,59342,medical,20210604
16,富山県,79326,45526,33800,medical,20210604
17,石川県,88235,51549,36686,medical,20210604
18,福井県,73990,40693,33297,medical,20210604
19,山梨県,54095,32796,21299,medical,20210604
20,長野県,133744,77494,56250,medical,20210604
21,岐阜県,142824,86332,56492,medical,20210604
22,静岡県,202344,120178,82166,medical,20210604
23,愛知県,458287,263732,194555,medical,20210604
24,三重県,123009,70084,52925,medical,20210604
25,滋賀県,86619,51309,35310,medical,20210604
26,京都府,171473,101351,70122,medical,20210604
27,大阪府,490365,294234,196131,medical,20210604
28,兵庫県,298855,179969,118886,medical,20210604
29,奈良県,102700,57854,44846,medical,20210604
30,和歌山県,74013,42635,31378,medical,20210604
31,鳥取県,46482,26504,19978,medical,20210604
32,島根県,57061,34789,22272,medical,20210604
33,岡山県,155102,92469,62633,medical,20210604
34,広島県,204067,119343,84724,medical,20210604
35,山口県,125064,70745,54319,medical,20210604
36,徳島県,74486,42656,31830,medical,20210604
37,香川県,71546,41435,30111,medical,20210604
38,愛媛県,115868,65718,50150,medical,20210604
39,高知県,63709,35218,28491,medical,20210604
40,福岡県,365196,225874,139322,medical,20210604
41,佐賀県,83645,47762,35883,medical,20210604
42,長崎県,117726,67408,50318,medical,20210604
43,熊本県,151671,88275,63396,medical,20210604
44,大分県,103266,56683,46583,medical,20210604
45,宮崎県,82856,48976,33880,medical,20210604
46,鹿児島県,140273,82563,57710,medical,20210604
47,沖縄県,94203,54078,40125,medical,20210604
1,北海道,298934,269897,29037,elderly,20210606
2,青森県,112266,98633,13633,elderly,20210606
3,岩手県,99318,84545,14773,elderly,20210606
4,宮城県,146035,132306,13729,elderly,20210606
5,秋田県,93447,74642,18805,elderly,20210606
6,山形県,126032,104738,21294,elderly,20210606
7,福島県,195270,172266,23004,elderly,20210606
8,茨城県,175233,158121,17112,elderly,20210606
9,栃木県,91682,80391,11291,elderly,20210606
10,群馬県,150695,136830,13865,elderly,20210606
11,埼玉県,411279,383749,27530,elderly,20210606
12,千葉県,372088,345142,26946,elderly,20210606
13,東京都,865691,801066,64625,elderly,20210606
14,神奈川県,435591,406659,28932,elderly,20210606
15,新潟県,190381,166804,23577,elderly,20210606
16,富山県,78639,75122,3517,elderly,20210606
17,石川県,129070,112545,16525,elderly,20210606
18,福井県,78034,68773,9261,elderly,20210606
19,山梨県,68097,57202,10895,elderly,20210606
20,長野県,171292,150117,21175,elderly,20210606
21,岐阜県,194529,176386,18143,elderly,20210606
22,静岡県,202452,185330,17122,elderly,20210606
23,愛知県,554063,499976,54087,elderly,20210606
24,三重県,129697,116237,13460,elderly,20210606
25,滋賀県,111323,97980,13343,elderly,20210606
26,京都府,206971,193549,13422,elderly,20210606
27,大阪府,519719,478553,41166,elderly,20210606
28,兵庫県,287013,260943,26070,elderly,20210606
29,奈良県,84519,73950,10569,elderly,20210606
30,和歌山県,144987,114653,30334,elderly,20210606
31,鳥取県,74446,62650,11796,elderly,20210606
32,島根県,66515,57217,9298,elderly,20210606
33,岡山県,207159,200415,6744,elderly,20210606
34,広島県,169357,150805,18552,elderly,20210606
35,山口県,193313,163305,30008,elderly,20210606
36,徳島県,77797,67102,10695,elderly,20210606
37,香川県,95317,75382,19935,elderly,20210606
38,愛媛県,93017,82452,10565,elderly,20210606
39,高知県,92292,82744,9548,elderly,20210606
40,福岡県,365977,348485,17492,elderly,20210606
41,佐賀県,99359,87342,12017,elderly,20210606
42,長崎県,102017,89848,12169,elderly,20210606
43,熊本県,178182,161507,16675,elderly,20210606
44,大分県,107650,92906,14744,elderly,20210606
45,宮崎県,133635,116246,17389,elderly,20210606
46,鹿児島県,134644,113685,20959,elderly,20210606
47,沖縄県,84976,70700,14276,elderly,20210606
1,北海道,420618,250086,170532,medical,20210611
2,青森県,93434,54745,38689,medical,20210611
3,岩手県,102026,55915,46111,medical,20210611
4,宮城県,176812,102204,74608,medical,20210611
5,秋田県,76218,43880,32338,medical,20210611
6,山形県,90972,50547,40425,medical,20210611
7,福島県,151195,84704,66491,medical,20210611
8,茨城県,210015,120823,89192,medical,20210611
9,栃木県,130076,73225,56851,medical,20210611
10,群馬県,147384,86669,60715,medical,20210611
11,埼玉県,442203,248222,193981,medical,20210611
12,千葉県,378605,220375,158230,medical,20210611
13,東京都,888744,502186,386558,medical,20210611
14,神奈川県,541120,312476,228644,medical,20210611
15,新潟県,156332,91384,64948,medical,20210611
16,富山県,84013,47392,36621,medical,20210611
17,石川県,97402,55800,41602,medical,20210611
18,福井県,78922,42535,36387,medical,20210611
19,山梨県,60557,34598,25959,medical,20210611
20,長野県,146858,82515,64343,medical,20210611
21,岐阜県,159625,91059,68566,medical,20210611
22,静岡県,228864,131075,97789,medical,20210611
23,愛知県,493430,278391,215039,medical,20210611
24,三重県,133148,73826,59322,medical,20210611
25,滋賀県,93727,53175,40552,medical,20210611
26,京都府,191219,111112,80107,medical,20210611
27,大阪府,546454,321849,224605,medical,20210611
28,兵庫県,367795,214176,153619,medical,20210611
29,奈良県,112198,61075,51123,medical,20210611
30,和歌山県,79193,44860,34333,medical,20210611
31,鳥取県,49279,28076,21203,medical,20210611
32,島根県,60907,35857,25050,medical,20210611
33,岡山県,173486,101209,72277,medical,20210611
34,広島県,219604,125863,93741,medical,20210611
35,山口県,134703,75115,59588,medical,20210611
36,徳島県,82668,45726,36942,medical,20210611
37,香川県,77645,43903,33742,medical,20210611
38,愛媛県,125139,70247,54892,medical,20210611
39,高知県,66545,36208,30337,medical,20210611
40,福岡県,402571,236175,166396,medical,20210611
41,佐賀県,90799,51276,39523,medical,20210611
42,長崎県,124452,68681,55771,medical,20210611
43,熊本県,162118,91307,70811,medical,20210611
44,大分県,112125,59779,52346,medical,20210611
45,宮崎県,89806,51355,38451,medical,20210611
46,鹿児島県,155977,88985,66992,medical,20210611
47,沖縄県,100914,56183,44731,medical,20210611
1,北海道,511938,434141,77797,elderly,20210613
2,青森県,173630,139989,33641,elderly,20210613
3,岩手県,148816,119281,29535,elderly,20210613
4,宮城県,214775,191552,23223,elderly,20210613
5,秋田県,129826,92614,37212,elderly,20210613
6,山形県,191839,154847,36992,elderly,20210613
7,福島県,300951,250915,50036,elderly,20210613
8,茨城県,280640,242468,38172,elderly,20210613
9,栃木県,169329,143668,25661,elderly,20210613
10,群馬県,238923,204887,34036,elderly,20210613
11,埼玉県,709007,623122,85885,elderly,20210613
12,千葉県,672747,592233,80514,elderly,20210613
13,東京都,1339104,1148562,190542,elderly,20210613
14,神奈川県,859331,743069,116262,elderly,20210613
15,新潟県,304005,253738,50267,elderly,20210613
16,富山県,135944,119117,16827,elderly,20210613
17,石川県,191569,156964,34605,elderly,20210613
18,福井県,116004,94854,21150,elderly,20210613
19,山梨県,100104,80886,19218,elderly,20210613
20,長野県,273780,223221,50559,elderly,20210613
21,岐阜県,313617,274456,39161,elderly,20210613
22,静岡県,343232,289872,53360,elderly,20210613
23,愛知県,926402,814340,112062,elderly,20210613
24,三重県,222732,190930,31802,elderly,20210613
25,滋賀県,171220,137305,33915,elderly,20210613
26,京都府,322150,271772,50378,elderly,20210613
27,大阪府,843191,734400,108791,elderly,20210613
28,兵庫県,479007,401544,77463,elderly,20210613
29,奈良県,159441,132566,26875,elderly,20210613
30,和歌山県,200276,145024,55252,elderly,20210613
31,鳥取県,107670,85591,22079,elderly,20210613
32,島根県,103160,88279,14881,elderly,20210613
33,岡山県,315135,272955,42180,elderly,20210613
34,広島県,278378,238281,40097,elderly,20210613
35,山口県,285750,217897,67853,elderly,20210613
36,徳島県,117282,97036,20246,elderly,20210613
37,香川県,150788,120424,30364,elderly,20210613
38,愛媛県,156328,135785,20543,elderly,20210613
39,高知県,115994,98686,17308,elderly,20210613
40,福岡県,598393,536124,62269,elderly,20210613
41,佐賀県,151724,125014,26710,elderly,20210613
42,長崎県,171572,148288,23284,elderly,20210613
43,熊本県,270426,234512,35914,elderly,20210613
44,大分県,171304,140995,30309,elderly,20210613
45,宮崎県,193149,156664,36485,elderly,20210613
46,鹿児島県,215276,172442,42834,elderly,20210613
47,沖縄県,131563,102453,29110,elderly,20210613
1,北海道,479104,271936,207168,medical,20210618
2,青森県,102613,57799,44814,medical,20210618
3,岩手県,109732,60241,49491,medical,20210618
4,宮城県,199272,118341,80931,medical,20210618
5,秋田県,81820,45599,36221,medical,20210618
6,山形県,95581,52480,43101,medical,20210618
7,福島県,159561,88224,71337,medical,20210618
8,茨城県,225272,126602,98670,medical,20210618
9,栃木県,135828,75749,60079,medical,20210618
10,群馬県,158623,90271,68352,medical,20210618
11,埼玉県,475962,264078,211884,medical,20210618
12,千葉県,410093,234137,175956,medical,20210618
13,東京都,947398,529040,418358,medical,20210618
14,神奈川県,583647,331804,251843,medical,20210618
15,新潟県,168648,96436,72212,medical,20210618
16,富山県,90365,49858,40507,medical,20210618
17,石川県,102951,57788,45163,medical,20210618
18,福井県,82598,43859,38739,medical,20210618
19,山梨県,64072,35504,28568,medical,20210618
20,長野県,157488,86426,71062,medical,20210618
21,岐阜県,172209,94128,78081,medical,20210618
22,静岡県,244002,137860,106142,medical,20210618
23,愛知県,529985,295653,234332,medical,20210618
24,三重県,145255,78609,66646,medical,20210618
25,滋賀県,99031,54310,44721,medical,20210618
26,京都府,206239,117051,89188,medical,20210618
27,大阪府,591725,342279,249446,medical,20210618
28,兵庫県,392473,223402,169071,medical,20210618
29,奈良県,117977,63850,54127,medical,20210618
30,和歌山県,84869,46504,38365,medical,20210618
31,鳥取県,51084,29236,21848,medical,20210618
32,島根県,66156,36921,29235,medical,20210618
33,岡山県,188111,105731,82380,medical,20210618
34,広島県,240480,134869,105611,medical,20210618
35,山口県,144054,79042,65012,medical,20210618
36,徳島県,86668,47228,39440,medical,20210618
37,香川県,84707,46638,38069,medical,20210618
38,愛媛県,135362,73823,61539,medical,20210618
39,高知県,70205,37803,32402,medical,20210618
40,福岡県,435000,242630,192370,medical,20210618
41,佐賀県,94896,52670,42226,medical,20210618
42,長崎県,133475,71646,61829,medical,20210618
43,熊本県,179079,95762,83317,medical,20210618
44,大分県,117635,62039,55596,medical,20210618
45,宮崎県,97645,53704,43941,medical,20210618
46,鹿児島県,166643,93344,73299,medical,20210618
47,沖縄県,106645,59252,47393,medical,20210618
1,北海道,741092,576244,164848,elderly,20210620
2,青森県,243593,174320,69273,elderly,20210620
3,岩手県,215908,162635,53273,elderly,20210620
4,宮城県,323627,273136,50491,elderly,20210620
5,秋田県,187068,127423,59645,elderly,20210620
6,山形県,270656,206495,64161,elderly,20210620
7,福島県,431093,319741,111352,elderly,20210620
8,茨城県,425925,334981,90944,elderly,20210620
9,栃木県,251276,198374,52902,elderly,20210620
10,群馬県,356653,283324,73329,elderly,20210620
11,埼玉県,1110341,901218,209123,elderly,20210620
12,千葉県,1013906,805128,208778,elderly,20210620
13,東京都,2016218,1572157,444061,elderly,20210620
14,神奈川県,1303865,1054042,249823,elderly,20210620
15,新潟県,488614,374707,113907,elderly,20210620
16,富山県,214851,167465,47386,elderly,20210620
17,石川県,263406,197178,66228,elderly,20210620
18,福井県,171493,127274,44219,elderly,20210620
19,山梨県,141058,106009,35049,elderly,20210620
20,長野県,411915,307842,104073,elderly,20210620
21,岐阜県,461819,363956,97863,elderly,20210620
22,静岡県,537795,416863,120932,elderly,20210620
23,愛知県,1361296,1098614,262682,elderly,20210620
24,三重県,365087,288908,76179,elderly,20210620
25,滋賀県,231046,176565,54481,elderly,20210620
26,京都府,468944,350240,118704,elderly,20210620
27,大阪府,1287904,1036071,251833,elderly,20210620
28,兵庫県,823900,660282,163618,elderly,20210620
29,奈良県,251454,196813,54641,elderly,20210620
30,和歌山県,274612,184517,90095,elderly,20210620
31,鳥取県,144714,102543,42171,elderly,20210620
32,島根県,151636,117942,33694,elderly,20210620
33,岡山県,437240,328434,108806,elderly,20210620
34,広島県,435432,347133,88299,elderly,20210620
35,山口県,385690,264197,121493,elderly,20210620
36,徳島県,166307,125414,40893,elderly,20210620
37,香川県,199018,150187,48831,elderly,20210620
38,愛媛県,236502,191001,45501,elderly,20210620
39,高知県,194981,139857,55124,elderly,20210620
40,福岡県,885031,692242,192789,elderly,20210620
41,佐賀県,216207,160228,55979,elderly,20210620
42,長崎県,270756,215325,55431,elderly,20210620
43,熊本県,390248,306574,83674,elderly,20210620
44,大分県,245134,186454,58680,elderly,20210620
45,宮崎県,262235,191402,70833,elderly,20210620
46,鹿児島県,319648,243088,76560,elderly,20210620
47,沖縄県,192598,140813,51785,elderly,20210620
1,北海道,760067,587673,172394,elderly,20210621
2,⻘森県,255035,179645,75390,elderly,20210621
3,岩手県,227233,169276,57957,elderly,20210621
4,宮城県,352966,296996,55970,elderly,20210621
5,秋田県,195971,134495,61476,elderly,20210621
6,山形県,288982,218575,70407,elderly,20210621
7,福島県,453257,330446,122811,elderly,20210621
8,茨城県,446953,347141,99812,elderly,20210621
9,栃木県,268674,210116,58558,elderly,20210621
10,群馬県,381883,298920,82963,elderly,20210621
11,埼玉県,1169476,937708,231768,elderly,20210621
12,千葉県,1074166,837616,236550,elderly,20210621
13,東京都,2101619,1622419,479200,elderly,20210621
14,神奈川県,1375052,1104314,270738,elderly,20210621
15,新潟県,514229,390445,123784,elderly,20210621
16,富山県,227861,174354,53507,elderly,20210621
17,石川県,277425,203050,74375,elderly,20210621
18,福井県,180542,131395,49147,elderly,20210621
19,山梨県,153311,112174,41137,elderly,20210621
20,⻑野県,437197,322571,114626,elderly,20210621
21,岐阜県,495674,379756,115918,elderly,20210621
22,静岡県,573609,438607,135002,elderly,20210621
23,愛知県,1426174,1133748,292426,elderly,20210621
24,三重県,378954,292196,86758,elderly,20210621
25,滋賀県,242058,183442,58616,elderly,20210621
26,京都府,502577,367067,135510,elderly,20210621
27,大阪府,1330496,1059738,270758,elderly,20210621
28,兵庫県,884908,705440,179468,elderly,20210621
29,奈良県,261891,205329,56562,elderly,20210621
30,和歌山県,286669,191529,95140,elderly,20210621
31,鳥取県,150166,104376,45790,elderly,20210621
32,島根県,160044,122256,37788,elderly,20210621
33,岡山県,460574,337849,122725,elderly,20210621
34,広島県,462136,364641,97495,elderly,20210621
35,山口県,403463,273258,130205,elderly,20210621
36,徳島県,175538,130348,45190,elderly,20210621
37,香川県,196797,143141,53656,elderly,20210621
38,愛媛県,274843,215854,58989,elderly,20210621
39,高知県,202440,143220,59220,elderly,20210621
40,福岡県,929316,711875,217441,elderly,20210621
41,佐賀県,229287,167763,61524,elderly,20210621
42,⻑崎県,283350,223607,59743,elderly,20210621
43,熊本県,392579,299887,92692,elderly,20210621
44,大分県,253280,189726,63554,elderly,20210621
45,宮崎県,275750,196821,78929,elderly,20210621
46,鹿児島県,331003,249911,81092,elderly,20210621
47,沖縄県,205799,150649,55150,elderly,20210621
1,北海道,518444,288261,230183,medical,20210625
2,青森県,109811,60309,49502,medical,20210625
3,岩手県,116700,63542,53158,medical,20210625
4,宮城県,219448,131598,87850,medical,20210625
5,秋田県,88972,49178,39794,medical,20210625
6,山形県,100127,53942,46185,medical,20210625
7,福島県,168401,93105,75296,medical,20210625
8,茨城県,234994,131033,103961,medical,20210625
9,栃木県,140311,77455,62856,medical,20210625
10,群馬県,169400,94374,75026,medical,20210625
11,埼玉県,504881,278469,226412,medical,20210625
12,千葉県,438976,246606,192370,medical,20210625
13,東京都,994909,548036,446873,medical,20210625
14,神奈川県,632546,346183,286363,medical,20210625
15,新潟県,183180,104531,78649,medical,20210625
16,富山県,96057,51826,44231,medical,20210625
17,石川県,109512,60602,48910,medical,20210625
18,福井県,85166,44945,40221,medical,20210625
19,山梨県,67669,37195,30474,medical,20210625
20,長野県,163270,88915,74355,medical,20210625
21,岐阜県,180966,96278,84688,medical,20210625
22,静岡県,265118,148385,116733,medical,20210625
23,愛知県,554631,306798,247833,medical,20210625
24,三重県,152362,81526,70836,medical,20210625
25,滋賀県,103400,56116,47284,medical,20210625
26,京都府,220728,121810,98918,medical,20210625
27,大阪府,642062,360286,281776,medical,20210625
28,兵庫県,427726,236228,191498,medical,20210625
29,奈良県,122816,66222,56594,medical,20210625
30,和歌山県,88705,48116,40589,medical,20210625
31,鳥取県,55866,30786,25080,medical,20210625
32,島根県,69112,37736,31376,medical,20210625
33,岡山県,203212,113583,89629,medical,20210625
34,広島県,255391,142529,112862,medical,20210625
35,山口県,151052,82396,68656,medical,20210625
36,徳島県,89232,47824,41408,medical,20210625
37,香川県,88652,48383,40269,medical,20210625
38,愛媛県,140763,76706,64057,medical,20210625
39,高知県,74857,39972,34885,medical,20210625
40,福岡県,457320,250988,206332,medical,20210625
41,佐賀県,103260,55429,47831,medical,20210625
42,長崎県,139517,74673,64844,medical,20210625
43,熊本県,211081,110650,100431,medical,20210625
44,大分県,121597,64218,57379,medical,20210625
45,宮崎県,103383,56067,47316,medical,20210625
46,鹿児島県,177362,98225,79137,medical,20210625
47,沖縄県,111470,61868,49602,medical,20210625
1,北海道,1051332,764957,286375,elderly,20210627
2,青森県,332163,223178,108985,elderly,20210627
3,岩手県,289755,206999,82756,elderly,20210627
4,宮城県,496172,386620,109552,elderly,20210627
5,秋田県,261219,185619,75600,elderly,20210627
6,山形県,393586,272970,120616,elderly,20210627
7,福島県,549803,380807,168996,elderly,20210627
8,茨城県,607103,445256,161847,elderly,20210627
9,栃木県,365924,271681,94243,elderly,20210627
10,群馬県,509626,380597,129029,elderly,20210627
11,埼玉県,1520350,1131866,388484,elderly,20210627
12,千葉県,1366988,999476,367512,elderly,20210627
13,東京都,2706842,1957027,749815,elderly,20210627
14,神奈川県,1860914,1408373,452541,elderly,20210627
15,新潟県,645475,460532,184943,elderly,20210627
16,富山県,295705,207109,88596,elderly,20210627
17,石川県,350382,236599,113783,elderly,20210627
18,福井県,228843,154856,73987,elderly,20210627
19,山梨県,206650,151506,55144,elderly,20210627
20,長野県,560696,394444,166252,elderly,20210627
21,岐阜県,631043,447158,183885,elderly,20210627
22,静岡県,750465,544024,206441,elderly,20210627
23,愛知県,1802963,1308325,494638,elderly,20210627
24,三重県,487031,344092,142939,elderly,20210627
25,滋賀県,306856,221066,85790,elderly,20210627
26,京都府,654096,448515,205581,elderly,20210627
27,大阪府,1704612,1290558,414054,elderly,20210627
28,兵庫県,1243001,932447,310554,elderly,20210627
29,奈良県,334983,251377,83606,elderly,20210627
30,和歌山県,338810,215693,123117,elderly,20210627
31,鳥取県,180682,118176,62506,elderly,20210627
32,島根県,199966,139695,60271,elderly,20210627
33,岡山県,564181,377197,186984,elderly,20210627
34,広島県,623453,470759,152694,elderly,20210627
35,山口県,498226,325968,172258,elderly,20210627
36,徳島県,221222,149393,71829,elderly,20210627
37,香川県,223702,156933,66769,elderly,20210627
38,愛媛県,330715,247629,83086,elderly,20210627
39,高知県,252462,166113,86349,elderly,20210627
40,福岡県,1254188,873436,380752,elderly,20210627
41,佐賀県,288838,195431,93407,elderly,20210627
42,長崎県,372014,266531,105483,elderly,20210627
43,熊本県,506566,355193,151373,elderly,20210627
44,大分県,316790,218124,98666,elderly,20210627
45,宮崎県,344844,228502,116342,elderly,20210627
46,鹿児島県,422872,304089,118783,elderly,20210627
47,沖縄県,269427,194690,74737,elderly,20210627
1,北海道,548235,300156,248079,medical,20210702
2,青森県,114688,62375,52313,medical,20210702
3,岩手県,122207,65515,56692,medical,20210702
4,宮城県,229136,135464,93672,medical,20210702
5,秋田県,92381,51758,40623,medical,20210702
6,山形県,103399,55104,48295,medical,20210702
7,福島県,179159,96477,82682,medical,20210702
8,茨城県,246115,135551,110564,medical,20210702
9,栃木県,147363,79482,67881,medical,20210702
10,群馬県,176915,97079,79836,medical,20210702
11,埼玉県,523466,286035,237431,medical,20210702
12,千葉県,460088,253947,206141,medical,20210702
13,東京都,1048177,570744,477433,medical,20210702
14,神奈川県,659583,360112,299471,medical,20210702
15,新潟県,194444,109995,84449,medical,20210702
16,富山県,100237,53562,46675,medical,20210702
17,石川県,115750,62367,53383,medical,20210702
18,福井県,88835,47295,41540,medical,20210702
19,山梨県,74816,41395,33421,medical,20210702
20,長野県,171830,92902,78928,medical,20210702
21,岐阜県,187480,98037,89443,medical,20210702
22,静岡県,277807,152513,125294,medical,20210702
23,愛知県,577950,317543,260407,medical,20210702
24,三重県,156789,83102,73687,medical,20210702
25,滋賀県,109335,57988,51347,medical,20210702
26,京都府,236302,130666,105636,medical,20210702
27,大阪府,680919,374362,306557,medical,20210702
28,兵庫県,453757,246288,207469,medical,20210702
29,奈良県,128892,68789,60103,medical,20210702
30,和歌山県,93207,50461,42746,medical,20210702
31,鳥取県,59623,31569,28054,medical,20210702
32,島根県,70906,38480,32426,medical,20210702
33,岡山県,215183,119242,95941,medical,20210702
34,広島県,268672,148042,120630,medical,20210702
35,山口県,157935,85906,72029,medical,20210702
36,徳島県,93924,49592,44332,medical,20210702
37,香川県,93344,50594,42750,medical,20210702
38,愛媛県,146816,78956,67860,medical,20210702
39,高知県,78854,42205,36649,medical,20210702
40,福岡県,469667,255725,213942,medical,20210702
41,佐賀県,108083,57466,50617,medical,20210702
42,長崎県,141797,75654,66143,medical,20210702
43,熊本県,225914,117825,108089,medical,20210702
44,大分県,124882,66202,58680,medical,20210702
45,宮崎県,106715,57559,49156,medical,20210702
46,鹿児島県,185358,101497,83861,medical,20210702
47,沖縄県,117416,64290,53126,medical,20210702
1,北海道,1345078,934722,410356,elderly,20210704
2,青森県,412964,265196,147768,elderly,20210704
3,岩手県,372618,250314,122304,elderly,20210704
4,宮城県,679217,457359,221858,elderly,20210704
5,秋田県,346071,252413,93658,elderly,20210704
6,山形県,481673,314683,166990,elderly,20210704
7,福島県,677914,440032,237882,elderly,20210704
8,茨城県,806254,541672,264582,elderly,20210704
9,栃木県,495669,345881,149788,elderly,20210704
10,群馬県,655238,456950,198288,elderly,20210704
11,埼玉県,1913062,1321302,591760,elderly,20210704
12,千葉県,1741557,1181816,559741,elderly,20210704
13,東京都,3503604,2358952,1144652,elderly,20210704
14,神奈川県,2404551,1715972,688579,elderly,20210704
15,新潟県,814236,542315,271921,elderly,20210704
16,富山県,375978,244194,131784,elderly,20210704
17,石川県,432147,271352,160795,elderly,20210704
18,福井県,294896,189066,105830,elderly,20210704
19,山梨県,276918,186569,90349,elderly,20210704
20,長野県,715389,473022,242367,elderly,20210704
21,岐阜県,786633,506536,280097,elderly,20210704
22,静岡県,1008175,689296,318879,elderly,20210704
23,愛知県,2256832,1471592,785240,elderly,20210704
24,三重県,614636,403625,211011,elderly,20210704
25,滋賀県,389965,268001,121964,elderly,20210704
26,京都府,805562,516463,289099,elderly,20210704
27,大阪府,2228920,1554940,673980,elderly,20210704
28,兵庫県,1709448,1204365,505083,elderly,20210704
29,奈良県,450387,313913,136474,elderly,20210704
30,和歌山県,409595,253367,156228,elderly,20210704
31,鳥取県,218682,134303,84379,elderly,20210704
32,島根県,249773,159221,90552,elderly,20210704
33,岡山県,687480,431686,255794,elderly,20210704
34,広島県,833046,578027,255019,elderly,20210704
35,山口県,604446,378907,225539,elderly,20210704
36,徳島県,285174,178984,106190,elderly,20210704
37,香川県,284086,187124,96962,elderly,20210704
38,愛媛県,445544,310077,135467,elderly,20210704
39,高知県,304553,190982,113571,elderly,20210704
40,福岡県,1624245,1066578,557667,elderly,20210704
41,佐賀県,352276,218983,133293,elderly,20210704
42,長崎県,479357,315143,164214,elderly,20210704
43,熊本県,650404,421385,229019,elderly,20210704
44,大分県,425866,276919,148947,elderly,20210704
45,宮崎県,423793,263881,159912,elderly,20210704
46,鹿児島県,537724,363833,173891,elderly,20210704
47,沖縄県,346960,241993,104967,elderly,20210704
1,北海道,580306,314908,265398,medical,20210712
2,青森県,119037,64273,54764,medical,20210712
3,岩手県,129006,69608,59398,medical,20210712
4,宮城県,247475,141687,105788,medical,20210712
5,秋田県,98621,54610,44011,medical,20210712
6,山形県,108354,57616,50738,medical,20210712
7,福島県,187384,99621,87763,medical,20210712
8,茨城県,257851,140623,117228,medical,20210712
9,栃木県,153260,81839,71421,medical,20210712
10,群馬県,183009,100123,82886,medical,20210712
11,埼玉県,547132,297370,249762,medical,20210712
12,千葉県,480861,262092,218769,medical,20210712
13,東京都,1091420,589802,501618,medical,20210712
14,神奈川県,692046,372043,320003,medical,20210712
15,新潟県,203437,115106,88331,medical,20210712
16,富山県,102967,54203,48764,medical,20210712
17,石川県,120937,64457,56480,medical,20210712
18,福井県,90697,48301,42396,medical,20210712
19,山梨県,77513,42726,34787,medical,20210712
20,長野県,184467,100392,84075,medical,20210712
21,岐阜県,193122,101035,92087,medical,20210712
22,静岡県,291151,158292,132859,medical,20210712
23,愛知県,594218,325107,269111,medical,20210712
24,三重県,162249,85649,76600,medical,20210712
25,滋賀県,113417,60155,53262,medical,20210712
26,京都府,245579,134197,111382,medical,20210712
27,大阪府,718506,389647,328859,medical,20210712
28,兵庫県,478863,256762,222101,medical,20210712
29,奈良県,133320,70554,62766,medical,20210712
30,和歌山県,97126,52297,44829,medical,20210712
31,鳥取県,61491,32385,29106,medical,20210712
32,島根県,72372,39181,33191,medical,20210712
33,岡山県,227831,128064,99767,medical,20210712
34,広島県,276576,148368,128208,medical,20210712
35,山口県,167426,91283,76143,medical,20210712
36,徳島県,95477,50341,45136,medical,20210712
37,香川県,97452,52316,45136,medical,20210712
38,愛媛県,151498,79878,71620,medical,20210712
39,高知県,81315,42903,38412,medical,20210712
40,福岡県,489038,261995,227043,medical,20210712
41,佐賀県,110627,58790,51837,medical,20210712
42,長崎県,147077,77754,69323,medical,20210712
43,熊本県,230169,119579,110590,medical,20210712
44,大分県,129499,69458,60041,medical,20210712
45,宮崎県,110037,58433,51604,medical,20210712
46,鹿児島県,192563,104157,88406,medical,20210712
47,沖縄県,123731,67817,55914,medical,20210712
1,北海道,1938252,1287985,650267,elderly,20210712
2,青森県,516586,331928,184658,elderly,20210712
3,岩手県,481933,314825,167108,elderly,20210712
4,宮城県,868285,546378,321907,elderly,20210712
5,秋田県,451044,322854,128190,elderly,20210712
6,山形県,581923,358299,223624,elderly,20210712
7,福島県,829505,521174,308331,elderly,20210712
8,茨城県,1046959,681186,365773,elderly,20210712
9,栃木県,656082,436310,219772,elderly,20210712
10,群馬県,830202,552719,277483,elderly,20210712
11,埼玉県,2483544,1617044,866500,elderly,20210712
12,千葉県,2177782,1414208,763574,elderly,20210712
13,東京都,4589278,2996415,1592863,elderly,20210712
14,神奈川県,3149669,2104615,1045054,elderly,20210712
15,新潟県,1035271,649424,385847,elderly,20210712
16,富山県,467905,293441,174464,elderly,20210712
17,石川県,523969,324358,199611,elderly,20210712
18,福井県,356790,225827,130963,elderly,20210712
19,山梨県,346533,222573,123960,elderly,20210712
20,長野県,893225,569539,323686,elderly,20210712
21,岐阜県,966135,595543,370592,elderly,20210712
22,静岡県,1313895,874975,438920,elderly,20210712
23,愛知県,2765538,1700545,1064993,elderly,20210712
24,三重県,761713,473006,288707,elderly,20210712
25,滋賀県,527987,340802,187185,elderly,20210712
26,京都府,1025535,639158,386377,elderly,20210712
27,大阪府,2986673,1944316,1042357,elderly,20210712
28,兵庫県,2239258,1480335,758923,elderly,20210712
29,奈良県,580844,381689,199155,elderly,20210712
30,和歌山県,504745,308748,195997,elderly,20210712
31,鳥取県,259672,159196,100476,elderly,20210712
32,島根県,303400,184735,118665,elderly,20210712
33,岡山県,858853,530037,328816,elderly,20210712
34,広島県,1062387,690562,371825,elderly,20210712
35,山口県,723891,450050,273841,elderly,20210712
36,徳島県,354642,217602,137040,elderly,20210712
37,香川県,386807,242145,144662,elderly,20210712
38,愛媛県,601693,391311,210382,elderly,20210712
39,高知県,358971,222963,136008,elderly,20210712
40,福岡県,2010628,1293515,717113,elderly,20210712
41,佐賀県,419668,254085,165583,elderly,20210712
42,長崎県,597585,381884,215701,elderly,20210712
43,熊本県,836885,527396,309489,elderly,20210712
44,大分県,519647,326804,192843,elderly,20210712
45,宮崎県,505753,312243,193510,elderly,20210712
46,鹿児島県,675998,432284,243714,elderly,20210712
47,沖縄県,436242,287171,149071,elderly,20210712
1,北海道,600054,322374,277680,medical,20210719
2,青森県,125082,66819,58263,medical,20210719
3,岩手県,132559,71386,61173,medical,20210719
4,宮城県,262923,145638,117285,medical,20210719
5,秋田県,104130,56343,47787,medical,20210719
6,山形県,110660,58503,52157,medical,20210719
7,福島県,196067,103523,92544,medical,20210719
8,茨城県,264820,142629,122191,medical,20210719
9,栃木県,157040,83586,73454,medical,20210719
10,群馬県,186165,100666,85499,medical,20210719
11,埼玉県,567194,306550,260644,medical,20210719
12,千葉県,496056,267056,229000,medical,20210719
13,東京都,1122840,600150,522690,medical,20210719
14,神奈川県,717260,384341,332919,medical,20210719
15,新潟県,210817,118113,92704,medical,20210719
16,富山県,105877,55662,50215,medical,20210719
17,石川県,123992,65653,58339,medical,20210719
18,福井県,91749,48481,43268,medical,20210719
19,山梨県,80174,43821,36353,medical,20210719
20,長野県,191229,103044,88185,medical,20210719
21,岐阜県,197084,102967,94117,medical,20210719
22,静岡県,300684,161594,139090,medical,20210719
23,愛知県,646720,360988,285732,medical,20210719
24,三重県,166200,87688,78512,medical,20210719
25,滋賀県,116374,61947,54427,medical,20210719
26,京都府,254597,139232,115365,medical,20210719
27,大阪府,749993,402721,347272,medical,20210719
28,兵庫県,490893,261788,229105,medical,20210719
29,奈良県,136086,71475,64611,medical,20210719
30,和歌山県,99718,53230,46488,medical,20210719
31,鳥取県,63006,33094,29912,medical,20210719
32,島根県,73911,40092,33819,medical,20210719
33,岡山県,236783,131852,104931,medical,20210719
34,広島県,288707,154792,133915,medical,20210719
35,山口県,176647,98012,78635,medical,20210719
36,徳島県,96713,50925,45788,medical,20210719
37,香川県,100981,53526,47455,medical,20210719
38,愛媛県,154941,80669,74272,medical,20210719
39,高知県,83662,43529,40133,medical,20210719
40,福岡県,500356,266090,234266,medical,20210719
41,佐賀県,112765,59666,53099,medical,20210719
42,長崎県,148646,78610,70036,medical,20210719
43,熊本県,232280,120233,112047,medical,20210719
44,大分県,133558,71817,61741,medical,20210719
45,宮崎県,113111,60197,52914,medical,20210719
46,鹿児島県,199881,107582,92299,medical,20210719
47,沖縄県,127452,69682,57770,medical,20210719
1,北海道,2327904,1493346,834558,elderly,20210719
2,青森県,630823,401249,229574,elderly,20210719
3,岩手県,563119,354840,208279,elderly,20210719
4,宮城県,1080505,650033,430472,elderly,20210719
5,秋田県,535420,346358,189062,elderly,20210719
6,山形県,680465,407853,272612,elderly,20210719
7,福島県,961113,585021,376092,elderly,20210719
8,茨城県,1267747,813896,453851,elderly,20210719
9,栃木県,770116,487145,282971,elderly,20210719
10,群馬県,1010618,645356,365262,elderly,20210719
11,埼玉県,2950262,1854411,1095851,elderly,20210719
12,千葉県,2616655,1644566,972089,elderly,20210719
13,東京都,5567001,3579442,1987559,elderly,20210719
14,神奈川県,3832741,2411304,1421437,elderly,20210719
15,新潟県,1215715,738904,476811,elderly,20210719
16,富山県,545142,335453,209689,elderly,20210719
17,石川県,616276,376470,239806,elderly,20210719
18,福井県,413157,258741,154416,elderly,20210719
19,山梨県,402812,240994,161818,elderly,20210719
20,長野県,1049113,644451,404662,elderly,20210719
21,岐阜県,1110995,660233,450762,elderly,20210719
22,静岡県,1579821,1001094,578727,elderly,20210719
23,愛知県,3262135,1961214,1300921,elderly,20210719
24,三重県,894721,544728,349993,elderly,20210719
25,滋賀県,636305,396130,240175,elderly,20210719
26,京都府,1203633,728064,475569,elderly,20210719
27,大阪府,3733818,2363296,1370522,elderly,20210719
28,兵庫県,2677892,1687354,990538,elderly,20210719
29,奈良県,688269,421309,266960,elderly,20210719
30,和歌山県,583842,352537,231305,elderly,20210719
31,鳥取県,299281,182254,117027,elderly,20210719
32,島根県,352753,213077,139676,elderly,20210719
33,岡山県,998858,619928,378930,elderly,20210719
34,広島県,1271653,787360,484293,elderly,20210719
35,山口県,841609,509856,331753,elderly,20210719
36,徳島県,403133,242606,160527,elderly,20210719
37,香川県,474055,281919,192136,elderly,20210719
38,愛媛県,679635,424322,255313,elderly,20210719
39,高知県,411973,249456,162517,elderly,20210719
40,福岡県,2369607,1489429,880178,elderly,20210719
41,佐賀県,485983,289844,196139,elderly,20210719
42,長崎県,716823,442599,274224,elderly,20210719
43,熊本県,976848,603640,373208,elderly,20210719
44,大分県,605317,373193,232124,elderly,20210719
45,宮崎県,580023,350322,229701,elderly,20210719
46,鹿児島県,805346,491756,313590,elderly,20210719
47,沖縄県,521736,334389,187347,elderly,20210719
1,北海道,612683,326461,286222,medical,20210726
2,青森県,126238,67229,59009,medical,20210726
3,岩手県,134353,71972,62381,medical,20210726
4,宮城県,273536,148498,125038,medical,20210726
5,秋田県,106537,57053,49484,medical,20210726
6,山形県,112462,59058,53404,medical,20210726
7,福島県,199744,104647,95097,medical,20210726
8,茨城県,268170,143672,124498,medical,20210726
9,栃木県,158844,84294,74550,medical,20210726
10,群馬県,191088,103301,87787,medical,20210726
11,埼玉県,580794,312262,268532,medical,20210726
12,千葉県,503873,269512,234361,medical,20210726
13,東京都,1144544,606764,537780,medical,20210726
14,神奈川県,730916,389647,341269,medical,20210726
15,新潟県,215527,120067,95460,medical,20210726
16,富山県,107378,56101,51277,medical,20210726
17,石川県,126660,66720,59940,medical,20210726
18,福井県,93554,48464,45090,medical,20210726
19,山梨県,81417,44169,37248,medical,20210726
20,長野県,193752,103991,89761,medical,20210726
21,岐阜県,199523,103651,95872,medical,20210726
22,静岡県,305005,162098,142907,medical,20210726
23,愛知県,674618,374666,299952,medical,20210726
24,三重県,168146,88551,79595,medical,20210726
25,滋賀県,118351,62577,55774,medical,20210726
26,京都府,258946,139984,118962,medical,20210726
27,大阪府,765772,408707,357065,medical,20210726
28,兵庫県,496353,263496,232857,medical,20210726
29,奈良県,137435,71807,65628,medical,20210726
30,和歌山県,100999,53614,47385,medical,20210726
31,鳥取県,63818,33443,30375,medical,20210726
32,島根県,74825,40380,34445,medical,20210726
33,岡山県,242026,132677,109349,medical,20210726
34,広島県,292916,156214,136702,medical,20210726
35,山口県,179755,99832,79923,medical,20210726
36,徳島県,97480,51217,46263,medical,20210726
37,香川県,103289,54342,48947,medical,20210726
38,愛媛県,157238,81438,75800,medical,20210726
39,高知県,85311,43793,41518,medical,20210726
40,福岡県,515740,278055,237685,medical,20210726
41,佐賀県,114748,60047,54701,medical,20210726
42,長崎県,149415,78936,70479,medical,20210726
43,熊本県,233360,120709,112651,medical,20210726
44,大分県,136325,73151,63174,medical,20210726
45,宮崎県,115689,61273,54416,medical,20210726
46,鹿児島県,202327,108296,94031,medical,20210726
47,沖縄県,129562,70218,59344,medical,20210726
1,北海道,2788671,1713376,1075295,elderly,20210726
2,青森県,710813,433269,277544,elderly,20210726
3,岩手県,645027,398494,246533,elderly,20210726
4,宮城県,1195962,716712,479250,elderly,20210726
5,秋田県,594973,357269,237704,elderly,20210726
6,山形県,736612,428974,307638,elderly,20210726
7,福島県,1059373,628693,430680,elderly,20210726
8,茨城県,1458035,913869,544166,elderly,20210726
9,栃木県,854504,521111,333393,elderly,20210726
10,群馬県,1147807,717157,430650,elderly,20210726
11,埼玉県,3295095,2013948,1281147,elderly,20210726
12,千葉県,2940980,1794889,1146091,elderly,20210726
13,東京都,6462328,4081931,2380397,elderly,20210726
14,神奈川県,4352404,2611852,1740552,elderly,20210726
15,新潟県,1336592,794768,541824,elderly,20210726
16,富山県,579385,347316,232069,elderly,20210726
17,石川県,678358,406196,272162,elderly,20210726
18,福井県,461164,278359,182805,elderly,20210726
19,山梨県,440339,251760,188579,elderly,20210726
20,長野県,1166973,694873,472100,elderly,20210726
21,岐阜県,1205408,701028,504380,elderly,20210726
22,静岡県,1793764,1088152,705612,elderly,20210726
23,愛知県,3616935,2163862,1453073,elderly,20210726
24,三重県,995282,589685,405597,elderly,20210726
25,滋賀県,723257,439716,283541,elderly,20210726
26,京都府,1339579,787809,551770,elderly,20210726
27,大阪府,4263999,2626470,1637529,elderly,20210726
28,兵庫県,3047746,1827018,1220728,elderly,20210726
29,奈良県,768336,451301,317035,elderly,20210726
30,和歌山県,639824,379084,260740,elderly,20210726
31,鳥取県,329752,197703,132049,elderly,20210726
32,島根県,386674,231770,154904,elderly,20210726
33,岡山県,1118667,686568,432099,elderly,20210726
34,広島県,1446992,862548,584444,elderly,20210726
35,山口県,932958,551170,381788,elderly,20210726
36,徳島県,441495,259792,181703,elderly,20210726
37,香川県,500214,295078,205136,elderly,20210726
38,愛媛県,754428,452692,301736,elderly,20210726
39,高知県,463878,274110,189768,elderly,20210726
40,福岡県,2724935,1676857,1048078,elderly,20210726
41,佐賀県,538606,316146,222460,elderly,20210726
42,長崎県,811600,489898,321702,elderly,20210726
43,熊本県,1080646,655185,425461,elderly,20210726
44,大分県,678726,407265,271461,elderly,20210726
45,宮崎県,632328,371594,260734,elderly,20210726
46,鹿児島県,906471,533031,373440,elderly,20210726
47,沖縄県,597992,372808,225184,elderly,20210726
1,北海道,3416926,1951605,1465321,elderly,20210810
2,青森県,949943,532348,417595,elderly,20210810
3,岩手県,818516,472500,346016,elderly,20210810
4,宮城県,1520435,880060,640375,elderly,20210810
5,秋田県,773989,428445,345544,elderly,20210810
6,山形県,905697,499146,406551,elderly,20210810
7,福島県,1359808,771579,588229,elderly,20210810
8,茨城県,1955108,1143669,811439,elderly,20210810
9,栃木県,1138235,659735,478500,elderly,20210810
10,群馬県,1511659,895220,616439,elderly,20210810
11,埼玉県,4324883,2480620,1844263,elderly,20210810
12,千葉県,3935173,2245123,1690050,elderly,20210810
13,東京都,8778387,5242079,3536308,elderly,20210810
14,神奈川県,5689478,3244554,2444924,elderly,20210810
15,新潟県,1703953,952247,751706,elderly,20210810
16,富山県,724915,404724,320191,elderly,20210810
17,石川県,849135,479718,369417,elderly,20210810
18,福井県,584732,331795,252937,elderly,20210810
19,山梨県,536127,294095,242032,elderly,20210810
20,長野県,1479772,822408,657364,elderly,20210810
21,岐阜県,1499905,839222,660683,elderly,20210810
22,静岡県,2346553,1340224,1006329,elderly,20210810
23,愛知県,4706950,2734424,1972526,elderly,20210810
24,三重県,1255518,705134,550384,elderly,20210810
25,滋賀県,954379,558851,395528,elderly,20210810
26,京都府,1700663,943610,757053,elderly,20210810
27,大阪府,5592226,3193248,2398978,elderly,20210810
28,兵庫県,3849985,2170736,1679249,elderly,20210810
29,奈良県,974336,548049,426287,elderly,20210810
30,和歌山県,805127,451697,353430,elderly,20210810
31,鳥取県,421015,238286,182729,elderly,20210810
32,島根県,495732,286510,209222,elderly,20210810
33,岡山県,1418931,800961,617970,elderly,20210810
34,広島県,1910075,1106734,803341,elderly,20210810
35,山口県,1194593,671712,522881,elderly,20210810
36,徳島県,552391,303823,248568,elderly,20210810
37,香川県,620232,348713,271519,elderly,20210810
38,愛媛県,983045,541329,441716,elderly,20210810
39,高知県,562922,317216,245706,elderly,20210810
40,福岡県,3531863,2036887,1494976,elderly,20210810
41,佐賀県,655720,362082,293638,elderly,20210810
42,長崎県,1061079,603811,457268,elderly,20210810
43,熊本県,1399477,809587,589890,elderly,20210810
44,大分県,839154,468718,370436,elderly,20210810
45,宮崎県,772951,421803,351148,elderly,20210810
46,鹿児島県,1132539,631120,501419,elderly,20210810
47,沖縄県,809280,476742,332538,elderly,20210810
1,北海道,622010,329121,292889,medical,20210802
2,青森県,127635,67672,59963,medical,20210802
3,岩手県,136340,72438,63902,medical,20210802
4,宮城県,279258,151012,128246,medical,20210802
5,秋田県,109968,57783,52185,medical,20210802
6,山形県,114558,59511,55047,medical,20210802
7,福島県,202123,105214,96909,medical,20210802
8,茨城県,272373,145190,127183,medical,20210802
9,栃木県,160736,85170,75566,medical,20210802
10,群馬県,193603,104105,89498,medical,20210802
11,埼玉県,594185,316629,277556,medical,20210802
12,千葉県,510380,270761,239619,medical,20210802
13,東京都,1156429,610484,545945,medical,20210802
14,神奈川県,744461,396406,348055,medical,20210802
15,新潟県,219377,120665,98712,medical,20210802
16,富山県,108367,56053,52314,medical,20210802
17,石川県,127843,66996,60847,medical,20210802
18,福井県,94396,48565,45831,medical,20210802
19,山梨県,80670,42589,38081,medical,20210802
20,長野県,196409,104803,91606,medical,20210802
21,岐阜県,202127,104076,98051,medical,20210802
22,静岡県,311028,163684,147344,medical,20210802
23,愛知県,683602,377735,305867,medical,20210802
24,三重県,170728,89383,81345,medical,20210802
25,滋賀県,121154,63126,58028,medical,20210802
26,京都府,262814,141663,121151,medical,20210802
27,大阪府,788849,419978,368871,medical,20210802
28,兵庫県,503825,265713,238112,medical,20210802
29,奈良県,138127,71939,66188,medical,20210802
30,和歌山県,101989,53764,48225,medical,20210802
31,鳥取県,64807,33734,31073,medical,20210802
32,島根県,75967,40916,35051,medical,20210802
33,岡山県,245459,132914,112545,medical,20210802
34,広島県,317115,166219,150896,medical,20210802
35,山口県,185631,101685,83946,medical,20210802
36,徳島県,98243,51317,46926,medical,20210802
37,香川県,104837,54695,50142,medical,20210802
38,愛媛県,158805,81880,76925,medical,20210802
39,高知県,86080,44293,41787,medical,20210802
40,福岡県,524934,284356,240578,medical,20210802
41,佐賀県,116046,60085,55961,medical,20210802
42,長崎県,151179,80004,71175,medical,20210802
43,熊本県,234197,121032,113165,medical,20210802
44,大分県,139125,73914,65211,medical,20210802
45,宮崎県,117802,61886,55916,medical,20210802
46,鹿児島県,204871,109133,95738,medical,20210802
47,沖縄県,133653,71873,61780,medical,20210802
1,北海道,3657465,2068442,1589023,elderly,20210816
2,青森県,1003421,558064,445357,elderly,20210816
3,岩手県,876412,496109,380303,elderly,20210816
4,宮城県,1637908,934940,702968,elderly,20210816
5,秋田県,814876,454849,360027,elderly,20210816
6,山形県,960928,531210,429718,elderly,20210816
7,福島県,1477497,829654,647843,elderly,20210816
8,茨城県,2098002,1201207,896795,elderly,20210816
9,栃木県,1216826,704245,512581,elderly,20210816
10,群馬県,1639836,955174,684662,elderly,20210816
11,埼玉県,4671267,2656944,2014323,elderly,20210816
12,千葉県,4238119,2405945,1832174,elderly,20210816
13,東京都,9689342,5166592,,elderly,20210816
14,神奈川県,6138561,3498317,2640244,elderly,20210816
15,新潟県,1810367,997306,813061,elderly,20210816
16,富山県,784723,436440,348283,elderly,20210816
17,石川県,906920,510291,396629,elderly,20210816
18,福井県,627131,355153,271978,elderly,20210816
19,山梨県,564539,313325,251214,elderly,20210816
20,長野県,1571637,866581,705056,elderly,20210816
21,岐阜県,1588002,891143,696859,elderly,20210816
22,静岡県,2510939,1435408,1075531,elderly,20210816
23,愛知県,5020288,2885637,2134651,elderly,20210816
24,三重県,1329970,740230,589740,elderly,20210816
25,滋賀県,1025616,595605,430011,elderly,20210816
26,京都府,1810469,996446,814023,elderly,20210816
27,大阪府,6116355,3160045,,elderly,20210816
28,兵庫県,4115876,2311651,1804225,elderly,20210816
29,奈良県,1036098,580071,456027,elderly,20210816
30,和歌山県,854682,475637,379045,elderly,20210816
31,鳥取県,448901,251099,197802,elderly,20210816
32,島根県,515670,292052,223618,elderly,20210816
33,岡山県,1499551,833255,666296,elderly,20210816
34,広島県,2042317,1175825,866492,elderly,20210816
35,山口県,1267652,707838,559814,elderly,20210816
36,徳島県,588080,323046,265034,elderly,20210816
37,香川県,666606,374349,292257,elderly,20210816
38,愛媛県,1026969,566570,460399,elderly,20210816
39,高知県,613308,343222,270086,elderly,20210816
40,福岡県,3796582,2174718,1621864,elderly,20210816
41,佐賀県,687362,376828,310534,elderly,20210816
42,長崎県,1146341,643924,502417,elderly,20210816
43,熊本県,1501941,862327,639614,elderly,20210816
44,大分県,902336,497496,404840,elderly,20210816
45,宮崎県,814139,443375,370764,elderly,20210816
46,鹿児島県,1209613,669650,539963,elderly,20210816
47,沖縄県,894500,524256,370244,elderly,20210816
1,北海道,4006358,2241776,1764582,elderly,20210823
2,青森県,1071192,593259,477933,elderly,20210823
3,岩手県,947235,527182,420053,elderly,20210823
4,宮城県,1760740,995142,765598,elderly,20210823
5,秋田県,870285,494408,375877,elderly,20210823
6,山形県,1010777,557754,453023,elderly,20210823
7,福島県,1584595,876959,707636,elderly,20210823
8,茨城県,2297162,1293130,1004032,elderly,20210823
9,栃木県,1341352,768323,573029,elderly,20210823
10,群馬県,1815374,1041039,774335,elderly,20210823
11,埼玉県,5174344,2916698,2257646,elderly,20210823
12,千葉県,4689973,2644328,2045645,elderly,20210823
13,東京都,10977582,6385882,4591700,elderly,20210823
14,神奈川県,6680319,3800396,2879923,elderly,20210823
15,新潟県,1926953,1059008,867945,elderly,20210823
16,富山県,844138,469530,374608,elderly,20210823
17,石川県,981140,548921,432219,elderly,20210823
18,福井県,679038,383590,295448,elderly,20210823
19,山梨県,612271,343010,269261,elderly,20210823
20,長野県,1670829,920870,749959,elderly,20210823
21,岐阜県,1721448,960691,760757,elderly,20210823
22,静岡県,2749726,1554919,1194807,elderly,20210823
23,愛知県,5516960,3115418,2401542,elderly,20210823
24,三重県,1419131,785109,634022,elderly,20210823
25,滋賀県,1109351,631001,478350,elderly,20210823
26,京都府,1975613,1096642,878971,elderly,20210823
27,大阪府,6669957,3714748,2955209,elderly,20210823
28,兵庫県,4453875,2483895,1969980,elderly,20210823
29,奈良県,1128731,628633,500098,elderly,20210823
30,和歌山県,919745,504957,414788,elderly,20210823
31,鳥取県,489902,273160,216742,elderly,20210823
32,島根県,582668,321841,260827,elderly,20210823
33,岡山県,1623942,888298,735644,elderly,20210823
34,広島県,2233120,1265053,968067,elderly,20210823
35,山口県,1359473,750947,608526,elderly,20210823
36,徳島県,634645,349256,285389,elderly,20210823
37,香川県,736870,417902,318968,elderly,20210823
38,愛媛県,1091885,607561,484324,elderly,20210823
39,高知県,633349,358786,274563,elderly,20210823
40,福岡県,4123018,2337179,1785839,elderly,20210823
41,佐賀県,729766,398906,330860,elderly,20210823
42,長崎県,1245688,694203,551485,elderly,20210823
43,熊本県,1644654,933486,711168,elderly,20210823
44,大分県,967419,530429,436990,elderly,20210823
45,宮崎県,875299,481614,393685,elderly,20210823
46,鹿児島県,1313529,727002,586527,elderly,20210823
47,沖縄県,986189,568190,417999,elderly,20210823
1,北海道,4339195,2409696,1929499,elderly,20210830
2,青森県,1163370,637301,526069,elderly,20210830
3,岩手県,1023339,563011,460328,elderly,20210830
4,宮城県,1925802,1075098,850704,elderly,20210830
5,秋田県,944141,517418,426723,elderly,20210830
6,山形県,1085979,595184,490795,elderly,20210830
7,福島県,1727112,944732,782380,elderly,20210830
8,茨城県,2526845,1404607,1122238,elderly,20210830
9,栃木県,1492056,838496,653560,elderly,20210830
10,群馬県,1986417,1128382,858035,elderly,20210830
11,埼玉県,5707497,3208407,2499090,elderly,20210830
12,千葉県,5178343,2904554,2273789,elderly,20210830
13,東京都,12169440,6961009,5208431,elderly,20210830
14,神奈川県,7415517,4195746,3219771,elderly,20210830
15,新潟県,2080114,1146466,933648,elderly,20210830
16,富山県,921168,512145,409023,elderly,20210830
17,石川県,1067493,591780,475713,elderly,20210830
18,福井県,759810,426788,333022,elderly,20210830
19,山梨県,672677,375995,296682,elderly,20210830
20,長野県,1820580,1001084,819496,elderly,20210830
21,岐阜県,1869431,1029080,840351,elderly,20210830
22,静岡県,3007499,1687996,1319503,elderly,20210830
23,愛知県,6096373,3403893,2692480,elderly,20210830
24,三重県,1550730,853811,696919,elderly,20210830
25,滋賀県,1221086,679211,541875,elderly,20210830
26,京都府,2073175,1146106,927069,elderly,20210830
27,大阪府,7207622,4016091,3191531,elderly,20210830
28,兵庫県,4836460,2695186,2141274,elderly,20210830
29,奈良県,1240695,685397,555298,elderly,20210830
30,和歌山県,986461,536834,449627,elderly,20210830
31,鳥取県,531468,294656,236812,elderly,20210830
32,島根県,629214,345184,284030,elderly,20210830
33,岡山県,1735244,943860,791384,elderly,20210830
34,広島県,2451021,1349294,1101727,elderly,20210830
35,山口県,1465413,793056,672357,elderly,20210830
36,徳島県,695872,382401,313471,elderly,20210830
37,香川県,818143,459932,358211,elderly,20210830
38,愛媛県,1214856,674975,539881,elderly,20210830
39,高知県,680692,378442,302250,elderly,20210830
40,福岡県,4507060,2523174,1983886,elderly,20210830
41,佐賀県,780690,427192,353498,elderly,20210830
42,長崎県,1355682,747129,608553,elderly,20210830
43,熊本県,1779568,996957,782611,elderly,20210830
44,大分県,1036091,564726,471365,elderly,20210830
45,宮崎県,944797,523024,421773,elderly,20210830
46,鹿児島県,1421740,783265,638475,elderly,20210830
47,沖縄県,1084130,613299,470831,elderly,20210830
1,北海道,4663574,2596532,2067042,elderly,20210906
2,青森県,1226416,671361,555055,elderly,20210906
3,岩手県,1094140,602312,491828,elderly,20210906
4,宮城県,2093971,1178836,915135,elderly,20210906
5,秋田県,994339,537910,456429,elderly,20210906
6,山形県,1149537,622561,526976,elderly,20210906
7,福島県,1815960,995504,820456,elderly,20210906
8,茨城県,2742783,1524792,1217991,elderly,20210906
9,栃木県,1636543,910160,726383,elderly,20210906
10,群馬県,2120859,1197935,922924,elderly,20210906
11,埼玉県,6244594,3524865,2719729,elderly,20210906
12,千葉県,5637517,3157958,2479559,elderly,20210906
13,東京都,13310795,7495450,5815345,elderly,20210906
14,神奈川県,8105854,4563281,3542573,elderly,20210906
15,新潟県,2256189,1247609,1008580,elderly,20210906
16,富山県,986512,548253,438259,elderly,20210906
17,石川県,1134177,625049,509128,elderly,20210906
18,福井県,819887,455641,364246,elderly,20210906
19,山梨県,735628,410323,325305,elderly,20210906
20,長野県,1935971,1071255,864716,elderly,20210906
21,岐阜県,2008364,1102804,905560,elderly,20210906
22,静岡県,3294859,1850712,1444147,elderly,20210906
23,愛知県,6598789,3711118,2887671,elderly,20210906
24,三重県,1681062,932848,748214,elderly,20210906
25,滋賀県,1327531,736695,590836,elderly,20210906
26,京都府,2201376,1223343,978033,elderly,20210906
27,大阪府,7752155,4319464,3432691,elderly,20210906
28,兵庫県,5198345,2893250,2305095,elderly,20210906
29,奈良県,1331508,740315,591193,elderly,20210906
30,和歌山県,1041819,566721,475098,elderly,20210906
31,鳥取県,568760,315245,253515,elderly,20210906
32,島根県,666358,363516,302842,elderly,20210906
33,岡山県,1833820,998843,834977,elderly,20210906
34,広島県,2659015,1460931,1198084,elderly,20210906
35,山口県,1545955,830897,715058,elderly,20210906
36,徳島県,742197,404890,337307,elderly,20210906
37,香川県,890784,496567,394217,elderly,20210906
38,愛媛県,1299398,718549,580849,elderly,20210906
39,高知県,731999,402684,329315,elderly,20210906
40,福岡県,4908479,2733881,2174598,elderly,20210906
41,佐賀県,824226,450309,373917,elderly,20210906
42,長崎県,1444500,797490,647010,elderly,20210906
43,熊本県,1901217,1041571,859646,elderly,20210906
44,大分県,1099758,599484,500274,elderly,20210906
45,宮崎県,1007504,561741,445763,elderly,20210906
46,鹿児島県,1530234,848720,681514,elderly,20210906
47,沖縄県,1203128,676436,526692,elderly,20210906
1,北海道,4979593,2772859,2206734,elderly,20210913
2,青森県,1306723,720406,586317,elderly,20210913
3,岩手県,1180820,658450,522370,elderly,20210913
4,宮城県,2260825,1281274,979551,elderly,20210913
5,秋田県,1056399,564062,492337,elderly,20210913
6,山形県,1209034,655048,553986,elderly,20210913
7,福島県,1930246,1063240,867006,elderly,20210913
8,茨城県,2979286,1672797,1306489,elderly,20210913
9,栃木県,1770378,992646,777732,elderly,20210913
10,群馬県,2259608,1254091,1005517,elderly,20210913
11,埼玉県,6832118,3858784,2973334,elderly,20210913
12,千葉県,6145251,3438614,2706637,elderly,20210913
13,東京都,14430140,8033096,6397044,elderly,20210913
14,神奈川県,8897397,4999838,3897559,elderly,20210913
15,新潟県,2421418,1340879,1080539,elderly,20210913
16,富山県,1068224,594563,473661,elderly,20210913
17,石川県,1209841,658632,551209,elderly,20210913
18,福井県,872428,481094,391334,elderly,20210913
19,山梨県,794071,442115,351956,elderly,20210913
20,長野県,2074357,1151591,922766,elderly,20210913
21,岐阜県,2148896,1181268,967628,elderly,20210913
22,静岡県,3597297,2027436,1569861,elderly,20210913
23,愛知県,7187013,4047505,3139508,elderly,20210913
24,三重県,1808859,1009405,799454,elderly,20210913
25,滋賀県,1433661,804564,629097,elderly,20210913
26,京都府,2400969,1342666,1058303,elderly,20210913
27,大阪府,8358471,4661000,3697471,elderly,20210913
28,兵庫県,5578435,3101107,2477328,elderly,20210913
29,奈良県,1426970,794542,632428,elderly,20210913
30,和歌山県,1098663,590840,507823,elderly,20210913
31,鳥取県,607361,334400,272961,elderly,20210913
32,島根県,710875,388480,322395,elderly,20210913
33,岡山県,1943344,1056429,886915,elderly,20210913
34,広島県,2885881,1582528,1303353,elderly,20210913
35,山口県,1616158,862194,753964,elderly,20210913
36,徳島県,785720,425447,360273,elderly,20210913
37,香川県,963510,533318,430192,elderly,20210913
38,愛媛県,1387032,761754,625278,elderly,20210913
39,高知県,776189,420368,355821,elderly,20210913
40,福岡県,5291305,2933012,2358293,elderly,20210913
41,佐賀県,869545,473242,396303,elderly,20210913
42,長崎県,1531496,838568,692928,elderly,20210913
43,熊本県,1999592,1076356,923236,elderly,20210913
44,大分県,1170115,641212,528903,elderly,20210913
45,宮崎県,1086285,602789,483496,elderly,20210913
46,鹿児島県,1667870,921254,746616,elderly,20210913
47,沖縄県,1320453,747433,573020,elderly,20210913
1,北海道,5353705,2969050,2384655,elderly,20210921
2,青森県,1406556,776220,630336,elderly,20210921
3,岩手県,1272919,707592,565327,elderly,20210921
4,宮城県,2449129,1379773,1069356,elderly,20210921
5,秋田県,1119028,604800,514228,elderly,20210921
6,山形県,1268721,679481,589240,elderly,20210921
7,福島県,2058779,1129021,929758,elderly,20210921
8,茨城県,3217400,1799258,1418142,elderly,20210921
9,栃木県,1930617,1085313,845304,elderly,20210921
10,群馬県,2407703,1308001,1099702,elderly,20210921
11,埼玉県,7442269,4176164,3266105,elderly,20210921
12,千葉県,6667629,3703428,2964201,elderly,20210921
13,東京都,15491599,8479651,7011948,elderly,20210921
14,神奈川県,9746722,5445772,4300950,elderly,20210921
15,新潟県,2599088,1429340,1169748,elderly,20210921
16,富山県,1152490,636227,516263,elderly,20210921
17,石川県,1287966,695059,592907,elderly,20210921
18,福井県,932279,506955,425324,elderly,20210921
19,山梨県,863029,478193,384836,elderly,20210921
20,長野県,2225211,1235197,990014,elderly,20210921
21,岐阜県,2301533,1260104,1041429,elderly,20210921
22,静岡県,3889946,2183004,1706942,elderly,20210921
23,愛知県,7833398,4398299,3435099,elderly,20210921
24,三重県,1946506,1081277,865229,elderly,20210921
25,滋賀県,1536859,860010,676849,elderly,20210921
26,京都府,2585110,1429331,1155779,elderly,20210921
27,大阪府,8953636,4953825,3999811,elderly,20210921
28,兵庫県,6022318,3324016,2698302,elderly,20210921
29,奈良県,1515838,837951,677887,elderly,20210921
30,和歌山県,1139820,605633,534187,elderly,20210921
31,鳥取県,643777,351042,292735,elderly,20210921
32,島根県,749364,406323,343041,elderly,20210921
33,岡山県,2039028,1102405,936623,elderly,20210921
34,広島県,3101266,1705963,1395303,elderly,20210921
35,山口県,1685017,890186,794831,elderly,20210921
36,徳島県,835891,446673,389218,elderly,20210921
37,香川県,1033439,567332,466107,elderly,20210921
38,愛媛県,1517891,822905,694986,elderly,20210921
39,高知県,816782,442800,373982,elderly,20210921
40,福岡県,5657400,3109215,2548185,elderly,20210921
41,佐賀県,917591,493286,424305,elderly,20210921
42,長崎県,1610691,870511,740180,elderly,20210921
43,熊本県,2091757,1116467,975290,elderly,20210921
44,大分県,1250919,685787,565132,elderly,20210921
45,宮崎県,1161129,638486,522643,elderly,20210921
46,鹿児島県,1759654,967091,792563,elderly,20210921
47,沖縄県,1428969,808304,620665,elderly,20210921
1,北海道,5613988,3095971,2518017,elderly,20210927
2,青森県,1469165,807391,661774,elderly,20210927
3,岩手県,1330854,736785,594069,elderly,20210927
4,宮城県,2580110,1435212,1144898,elderly,20210927
5,秋田県,1171722,637110,534612,elderly,20210927
6,山形県,1312288,699663,612625,elderly,20210927
7,福島県,2144447,1165208,979239,elderly,20210927
8,茨城県,3386324,1878748,1507576,elderly,20210927
9,栃木県,2054511,1159429,895082,elderly,20210927
10,群馬県,2510773,1334958,1175815,elderly,20210927
11,埼玉県,7873796,4376928,3496868,elderly,20210927
12,千葉県,7040895,3877862,3163033,elderly,20210927
13,東京都,16253259,8797391,7455868,elderly,20210927
14,神奈川県,10336598,5720258,4616340,elderly,20210927
15,新潟県,2726700,1474430,1252270,elderly,20210927
16,富山県,1214514,669164,545350,elderly,20210927
17,石川県,1342787,722168,620619,elderly,20210927
18,福井県,968644,520217,448427,elderly,20210927
19,山梨県,907651,497322,410329,elderly,20210927
20,長野県,2335414,1288328,1047086,elderly,20210927
21,岐阜県,2407679,1306626,1101053,elderly,20210927
22,静岡県,4112321,2285058,1827263,elderly,20210927
23,愛知県,8279573,4587235,3692338,elderly,20210927
24,三重県,2058540,1131629,926911,elderly,20210927
25,滋賀県,1620054,900812,719242,elderly,20210927
26,京都府,2718520,1484482,1234038,elderly,20210927
27,大阪府,9409286,5153089,4256197,elderly,20210927
28,兵庫県,6297784,3452824,2844960,elderly,20210927
29,奈良県,1588368,867924,720444,elderly,20210927
30,和歌山県,1175870,615001,560869,elderly,20210927
31,鳥取県,671740,360985,310755,elderly,20210927
32,島根県,780874,419783,361091,elderly,20210927
33,岡山県,2105163,1127635,977528,elderly,20210927
34,広島県,3248210,1762666,1485544,elderly,20210927
35,山口県,1738691,913237,825454,elderly,20210927
36,徳島県,866706,460393,406313,elderly,20210927
37,香川県,1082515,588957,493558,elderly,20210927
38,愛媛県,1556383,838324,718059,elderly,20210927
39,高知県,852863,458001,394862,elderly,20210927
40,福岡県,5983247,3244110,2739137,elderly,20210927
41,佐賀県,953984,508904,445080,elderly,20210927
42,長崎県,1671095,888130,782965,elderly,20210927
43,熊本県,2165848,1146728,1019120,elderly,20210927
44,大分県,1306440,710489,595951,elderly,20210927
45,宮崎県,1218339,664201,554138,elderly,20210927
46,鹿児島県,1840963,1004861,836102,elderly,20210927
47,沖縄県,1496485,837738,658747,elderly,20210927
1,北海道,5999747,3282471,2717276,elderly,20211004
2,青森県,1557463,851933,705530,elderly,20211004
3,岩手県,1410844,770458,640386,elderly,20211004
4,宮城県,2756572,1495510,1261062,elderly,20211004
5,秋田県,1235086,675735,559351,elderly,20211004
6,山形県,1367546,725031,642515,elderly,20211004
7,福島県,2264187,1217417,1046770,elderly,20211004
8,茨城県,3586401,1967963,1618438,elderly,20211004
9,栃木県,2219628,1241682,977946,elderly,20211004
10,群馬県,2616914,1377758,1239156,elderly,20211004
11,埼玉県,8458431,4643174,3815257,elderly,20211004
12,千葉県,7485115,4075716,3409399,elderly,20211004
13,東京都,17096822,9126883,7969939,elderly,20211004
14,神奈川県,11000895,5997389,5003506,elderly,20211004
15,新潟県,2875109,1535427,1339682,elderly,20211004
16,富山県,1294947,708724,586223,elderly,20211004
17,石川県,1403257,752954,650303,elderly,20211004
18,福井県,1011608,534937,476671,elderly,20211004
19,山梨県,1007257,541906,465351,elderly,20211004
20,長野県,2479452,1352174,1127278,elderly,20211004
21,岐阜県,2519323,1352922,1166401,elderly,20211004
22,静岡県,4410301,2410113,2000188,elderly,20211004
23,愛知県,8827855,4801552,4026303,elderly,20211004
24,三重県,2172273,1177201,995072,elderly,20211004
25,滋賀県,1719105,939564,779541,elderly,20211004
26,京都府,2886169,1561349,1324820,elderly,20211004
27,大阪府,10024332,5413808,4610524,elderly,20211004
28,兵庫県,6653995,3597122,3056873,elderly,20211004
29,奈良県,1680960,905863,775097,elderly,20211004
30,和歌山県,1214909,632807,582102,elderly,20211004
31,鳥取県,698995,371000,327995,elderly,20211004
32,島根県,825692,439065,386627,elderly,20211004
33,岡山県,2203106,1169457,1033649,elderly,20211004
34,広島県,3417112,1831425,1585687,elderly,20211004
35,山口県,1791936,935662,856274,elderly,20211004
36,徳島県,910189,483437,426752,elderly,20211004
37,香川県,1136834,608802,528032,elderly,20211004
38,愛媛県,1619377,869016,750361,elderly,20211004
39,高知県,886625,472929,413696,elderly,20211004
40,福岡県,6288377,3359469,2928908,elderly,20211004
41,佐賀県,1000396,531042,469354,elderly,20211004
42,長崎県,1721627,903132,818495,elderly,20211004
43,熊本県,2256627,1191269,1065358,elderly,20211004
44,大分県,1377415,740251,637164,elderly,20211004
45,宮崎県,1287862,693430,594432,elderly,20211004
46,鹿児島県,1932558,1039647,892911,elderly,20211004
47,沖縄県,1587196,867787,719409,elderly,20211004
1,北海道,6314483,3412480,2902003,elderly,20211011
2,青森県,1648507,895046,753461,elderly,20211011
3,岩手県,1503790,815141,688649,elderly,20211011
4,宮城県,2905009,1552667,1352342,elderly,20211011
5,秋田県,1291079,694754,596325,elderly,20211011
6,山形県,1426338,756981,669357,elderly,20211011
7,福島県,2378345,1270395,1107950,elderly,20211011
8,茨城県,3781043,2043555,1737488,elderly,20211011
9,栃木県,2400189,1319580,1080609,elderly,20211011
10,群馬県,2697644,1411437,1286207,elderly,20211011
11,埼玉県,8975318,4871888,4103430,elderly,20211011
12,千葉県,7905371,4263017,3642354,elderly,20211011
13,東京都,17774031,9395136,8378895,elderly,20211011
14,神奈川県,11641245,6237877,5403368,elderly,20211011
15,新潟県,3008024,1590543,1417481,elderly,20211011
16,富山県,1373675,745820,627855,elderly,20211011
17,石川県,1463613,777895,685718,elderly,20211011
18,福井県,1051688,552308,499380,elderly,20211011
19,山梨県,1058208,561928,496280,elderly,20211011
20,長野県,2616407,1408507,1207900,elderly,20211011
21,岐阜県,2642969,1401368,1241601,elderly,20211011
22,静岡県,4727521,2561009,2166512,elderly,20211011
23,愛知県,9311692,4992801,4318891,elderly,20211011
24,三重県,2284985,1221179,1063806,elderly,20211011
25,滋賀県,1814994,977891,837103,elderly,20211011
26,京都府,3039227,1629656,1409571,elderly,20211011
27,大阪府,10523937,5623279,4900658,elderly,20211011
28,兵庫県,6984697,3729221,3255476,elderly,20211011
29,奈良県,1753675,930724,822951,elderly,20211011
30,和歌山県,1249131,647663,601468,elderly,20211011
31,鳥取県,724092,378097,345995,elderly,20211011
32,島根県,860111,456675,403436,elderly,20211011
33,岡山県,2295521,1211425,1084096,elderly,20211011
34,広島県,3554188,1878281,1675907,elderly,20211011
35,山口県,1837260,954305,882955,elderly,20211011
36,徳島県,944338,499994,444344,elderly,20211011
37,香川県,1192738,631991,560747,elderly,20211011
38,愛媛県,1692400,899163,793237,elderly,20211011
39,高知県,919863,484643,435220,elderly,20211011
40,福岡県,6524990,3450676,3074314,elderly,20211011
41,佐賀県,1038584,548764,489820,elderly,20211011
42,長崎県,1776406,923851,852555,elderly,20211011
43,熊本県,2338449,1227323,1111126,elderly,20211011
44,大分県,1436923,763691,673232,elderly,20211011
45,宮崎県,1354370,722013,632357,elderly,20211011
46,鹿児島県,2015332,1070218,945114,elderly,20211011
47,沖縄県,1667592,890830,776762,elderly,20211011
1,北海道,6539316,3504410,3034906,elderly,20211018
2,青森県,1715112,926104,789008,elderly,20211018
3,岩手県,1576928,848068,728860,elderly,20211018
4,宮城県,3031251,1602629,1428622,elderly,20211018
5,秋田県,1342363,710027,632336,elderly,20211018
6,山形県,1479003,783269,695734,elderly,20211018
7,福島県,2477277,1323661,1153616,elderly,20211018
8,茨城県,3951444,2106761,1844683,elderly,20211018
9,栃木県,2524953,1363501,1161452,elderly,20211018
10,群馬県,2755865,1432992,1322873,elderly,20211018
11,埼玉県,9433065,5074768,4358297,elderly,20211018
12,千葉県,8278273,4426444,3851829,elderly,20211018
13,東京都,18316017,9599428,8716589,elderly,20211018
14,神奈川県,12166915,6454288,5712627,elderly,20211018
15,新潟県,3109669,1638237,1471432,elderly,20211018
16,富山県,1427278,764172,663106,elderly,20211018
17,石川県,1508006,793866,714140,elderly,20211018
18,福井県,1081791,565055,516736,elderly,20211018
19,山梨県,1095301,576405,518896,elderly,20211018
20,長野県,2733814,1460208,1273606,elderly,20211018
21,岐阜県,2727106,1437422,1289684,elderly,20211018
22,静岡県,4985999,2689955,2296044,elderly,20211018
23,愛知県,9694020,5135415,4558605,elderly,20211018
24,三重県,2370136,1256283,1113853,elderly,20211018
25,滋賀県,1886932,1000910,886022,elderly,20211018
26,京都府,3181991,1685780,1496211,elderly,20211018
27,大阪府,10905972,5781163,5124809,elderly,20211018
28,兵庫県,7254931,3826695,3428236,elderly,20211018
29,奈良県,1812581,950742,861839,elderly,20211018
30,和歌山県,1268773,655462,613311,elderly,20211018
31,鳥取県,740020,382653,357367,elderly,20211018
32,島根県,885608,469168,416440,elderly,20211018
33,岡山県,2362596,1244955,1117641,elderly,20211018
34,広島県,3665545,1911602,1753943,elderly,20211018
35,山口県,1863268,960897,902371,elderly,20211018
36,徳島県,974741,508202,466539,elderly,20211018
37,香川県,1241301,654050,587251,elderly,20211018
38,愛媛県,1749328,923303,826025,elderly,20211018
39,高知県,943758,491058,452700,elderly,20211018
40,福岡県,6716955,3512269,3204686,elderly,20211018
41,佐賀県,1064203,558233,505970,elderly,20211018
42,長崎県,1810614,938852,871762,elderly,20211018
43,熊本県,2403061,1244943,1158118,elderly,20211018
44,大分県,1492483,784190,708293,elderly,20211018
45,宮崎県,1403694,742647,661047,elderly,20211018
46,鹿児島県,2083258,1094892,988366,elderly,20211018
47,沖縄県,1719959,904287,815672,elderly,20211018
1,北海道,6815933,3603695,3212238,elderly,20211025
2,青森県,1777474,941902,835572,elderly,20211025
3,岩手県,1647891,878568,769323,elderly,20211025
4,宮城県,3131229,1637606,1493623,elderly,20211025
5,秋田県,1400857,727606,673251,elderly,20211025
6,山形県,1524411,798840,725571,elderly,20211025
7,福島県,2547122,1355744,1191378,elderly,20211025
8,茨城県,4105465,2153568,1951897,elderly,20211025
9,栃木県,2647982,1404698,1243284,elderly,20211025
10,群馬県,2783644,1431321,1352323,elderly,20211025
11,埼玉県,9835221,5223803,4611418,elderly,20211025
12,千葉県,8567537,4519392,4048145,elderly,20211025
13,東京都,18815727,9751995,9063732,elderly,20211025
14,神奈川県,12604463,6589628,6014835,elderly,20211025
15,新潟県,3198830,1671424,1527406,elderly,20211025
16,富山県,1486024,780581,705443,elderly,20211025
17,石川県,1551874,805712,746162,elderly,20211025
18,福井県,1098368,568695,529673,elderly,20211025
19,山梨県,1129134,587614,541520,elderly,20211025
20,長野県,2826550,1490603,1335947,elderly,20211025
21,岐阜県,2812218,1469357,1342861,elderly,20211025
22,静岡県,5199852,2766509,2433343,elderly,20211025
23,愛知県,10018824,5237015,4781809,elderly,20211025
24,三重県,2453890,1289182,1164708,elderly,20211025
25,滋賀県,1953531,1022704,930827,elderly,20211025
26,京都府,3275420,1717614,1557806,elderly,20211025
27,大阪府,11233575,5903157,5330418,elderly,20211025
28,兵庫県,7497361,3911240,3586121,elderly,20211025
29,奈良県,1861248,962566,898682,elderly,20211025
30,和歌山県,1287842,660071,627771,elderly,20211025
31,鳥取県,754547,385617,368930,elderly,20211025
32,島根県,912951,478560,434391,elderly,20211025
33,岡山県,2426985,1272167,1154818,elderly,20211025
34,広島県,3749050,1929896,1819154,elderly,20211025
35,山口県,1891477,965541,925936,elderly,20211025
36,徳島県,1006983,518460,488523,elderly,20211025
37,香川県,1273144,667021,606123,elderly,20211025
38,愛媛県,1811015,946533,864482,elderly,20211025
39,高知県,963731,494943,468788,elderly,20211025
40,福岡県,6884038,3564386,3319652,elderly,20211025
41,佐賀県,1089341,565240,524101,elderly,20211025
42,長崎県,1845782,951643,894139,elderly,20211025
43,熊本県,2448205,1258275,1189930,elderly,20211025
44,大分県,1524555,795265,729290,elderly,20211025
45,宮崎県,1447571,753752,693819,elderly,20211025
46,鹿児島県,2141870,1116425,1025445,elderly,20211025
47,沖縄県,1763919,914235,849684,elderly,20211025
1,北海道,7005774,3672336,3333438,elderly,20211101
2,青森県,1837245,953083,884162,elderly,20211101
3,岩手県,1717771,905224,812547,elderly,20211101
4,宮城県,3204504,1661573,1542931,elderly,20211101
5,秋田県,1435185,740794,694391,elderly,20211101
6,山形県,1563144,807232,755912,elderly,20211101
7,福島県,2625012,1378653,1246359,elderly,20211101
8,茨城県,4242455,2189053,2053402,elderly,20211101
9,栃木県,2760111,1443638,1316473,elderly,20211101
10,群馬県,2824687,1439383,1385304,elderly,20211101
11,埼玉県,10191725,5339421,4852304,elderly,20211101
12,千葉県,8828052,4589852,4238200,elderly,20211101
13,東京都,19270555,9890963,9379592,elderly,20211101
14,神奈川県,12961189,6690556,6270633,elderly,20211101
15,新潟県,3266687,1685355,1581332,elderly,20211101
16,富山県,1530614,790545,740069,elderly,20211101
17,石川県,1584426,813444,770982,elderly,20211101
18,福井県,1121199,571841,549358,elderly,20211101
19,山梨県,1152989,595221,557768,elderly,20211101
20,長野県,2906588,1515914,1390674,elderly,20211101
21,岐阜県,2877655,1488498,1389157,elderly,20211101
22,静岡県,5354689,2790867,2563822,elderly,20211101
23,愛知県,10308065,5296134,5011931,elderly,20211101
24,三重県,2519237,1305056,1214181,elderly,20211101
25,滋賀県,2008355,1037115,971240,elderly,20211101
26,京都府,3374124,1745750,1628374,elderly,20211101
27,大阪府,11611641,6032871,5578770,elderly,20211101
28,兵庫県,7680444,3966207,3714237,elderly,20211101
29,奈良県,1900721,972221,928500,elderly,20211101
30,和歌山県,1304828,663885,640943,elderly,20211101
31,鳥取県,763168,387318,375850,elderly,20211101
32,島根県,939021,484711,454310,elderly,20211101
33,岡山県,2491262,1292654,1198608,elderly,20211101
34,広島県,3818713,1947494,1871219,elderly,20211101
35,山口県,1915689,968082,947607,elderly,20211101
36,徳島県,1027850,521478,506372,elderly,20211101
37,香川県,1307895,678209,629686,elderly,20211101
38,愛媛県,1867715,971486,896229,elderly,20211101
39,高知県,976880,497416,479464,elderly,20211101
40,福岡県,7026698,3610752,3415946,elderly,20211101
41,佐賀県,1117430,571609,545821,elderly,20211101
42,長崎県,1874218,958079,916139,elderly,20211101
43,熊本県,2487994,1267705,1220289,elderly,20211101
44,大分県,1560028,805915,754113,elderly,20211101
45,宮崎県,1484804,762885,721919,elderly,20211101
46,鹿児島県,2201199,1138250,1062949,elderly,20211101
47,沖縄県,1795189,922139,873050,elderly,20211101
1,北海道,7123768,3710661,3413107,elderly,20211108
2,青森県,1878130,963046,915084,elderly,20211108
3,岩手県,1761165,916245,844920,elderly,20211108
4,宮城県,3261382,1674706,1586676,elderly,20211108
5,秋田県,1453884,744936,708948,elderly,20211108
6,山形県,1596601,817141,779460,elderly,20211108
7,福島県,2682698,1391578,1291120,elderly,20211108
8,茨城県,4312409,2205836,2106573,elderly,20211108
9,栃木県,2821940,1463191,1358749,elderly,20211108
10,群馬県,2852631,1444013,1408618,elderly,20211108
11,埼玉県,10434419,5405870,5028549,elderly,20211108
12,千葉県,9015362,4633394,4381968,elderly,20211108
13,東京都,19524776,9960310,9564466,elderly,20211108
14,神奈川県,13213917,6749979,6463938,elderly,20211108
15,新潟県,3321809,1694745,1627064,elderly,20211108
16,富山県,1560585,798514,762071,elderly,20211108
17,石川県,1607596,817896,789700,elderly,20211108
18,福井県,1136118,573529,562589,elderly,20211108
19,山梨県,1175200,599145,576055,elderly,20211108
20,長野県,2972799,1528253,1444546,elderly,20211108
21,岐阜県,2923159,1495123,1428036,elderly,20211108
22,静岡県,5472705,2812259,2660446,elderly,20211108
23,愛知県,10469500,5329136,5140364,elderly,20211108
24,三重県,2564892,1316435,1248457,elderly,20211108
25,滋賀県,2041126,1046201,994925,elderly,20211108
26,京都府,3441582,1760207,1681375,elderly,20211108
27,大阪府,11826656,6084040,5742616,elderly,20211108
28,兵庫県,7788059,3989018,3799041,elderly,20211108
29,奈良県,1928850,979861,948989,elderly,20211108
30,和歌山県,1310819,663296,647523,elderly,20211108
31,鳥取県,767972,388350,379622,elderly,20211108
32,島根県,956278,488603,467675,elderly,20211108
33,岡山県,2536998,1303132,1233866,elderly,20211108
34,広島県,3864953,1960022,1904931,elderly,20211108
35,山口県,1926318,970836,955482,elderly,20211108
36,徳島県,1037594,523704,513890,elderly,20211108
37,香川県,1333896,683673,650223,elderly,20211108
38,愛媛県,1900663,977283,923380,elderly,20211108
39,高知県,985932,499539,486393,elderly,20211108
40,福岡県,7113421,3643795,3469626,elderly,20211108
41,佐賀県,1129749,574669,555080,elderly,20211108
42,長崎県,1896408,962924,933484,elderly,20211108
43,熊本県,2511792,1274660,1237132,elderly,20211108
44,大分県,1576893,808277,768616,elderly,20211108
45,宮崎県,1504753,766935,737818,elderly,20211108
46,鹿児島県,2229305,1146730,1082575,elderly,20211108
47,沖縄県,1816569,929532,887037,elderly,20211108
1,北海道,7229411,3740008,3489403,elderly,20211115
2,青森県,1902066,966618,935448,elderly,20211115
3,岩手県,1800154,927279,872875,elderly,20211115
4,宮城県,3318808,1687953,1630855,elderly,20211115
5,秋田県,1467945,750273,717672,elderly,20211115
6,山形県,1617923,822527,795396,elderly,20211115
7,福島県,2735064,1401809,1333255,elderly,20211115
8,茨城県,4364670,2217556,2147114,elderly,20211115
9,栃木県,2869815,1471360,1398455,elderly,20211115
10,群馬県,2868857,1448174,1420683,elderly,20211115
11,埼玉県,10641241,5450785,5190456,elderly,20211115
12,千葉県,9165822,4674880,4490942,elderly,20211115
13,東京都,19741061,10016607,9724454,elderly,20211115
14,神奈川県,13398429,6798351,6600078,elderly,20211115
15,新潟県,3363992,1699369,1664623,elderly,20211115
16,富山県,1581425,804691,776734,elderly,20211115
17,石川県,1634256,828473,805783,elderly,20211115
18,福井県,1140301,574671,565630,elderly,20211115
19,山梨県,1193035,603687,589348,elderly,20211115
20,長野県,3020016,1537307,1482709,elderly,20211115
21,岐阜県,2958438,1499902,1458536,elderly,20211115
22,静岡県,5542079,2826439,2715640,elderly,20211115
23,愛知県,10585693,5355064,5230629,elderly,20211115
24,三重県,2603836,1323584,1280252,elderly,20211115
25,滋賀県,2058174,1047104,1011070,elderly,20211115
26,京都府,3498143,1779190,1718953,elderly,20211115
27,大阪府,12024601,6132823,5891778,elderly,20211115
28,兵庫県,7899008,4016121,3882887,elderly,20211115
29,奈良県,1945952,984462,961490,elderly,20211115
30,和歌山県,1318467,665399,653068,elderly,20211115
31,鳥取県,773048,390090,382958,elderly,20211115
32,島根県,968549,492422,476127,elderly,20211115
33,岡山県,2574812,1310881,1263931,elderly,20211115
34,広島県,3901598,1972888,1928710,elderly,20211115
35,山口県,1934312,974680,959632,elderly,20211115
36,徳島県,1042210,525013,517197,elderly,20211115
37,香川県,1354029,687777,666252,elderly,20211115
38,愛媛県,1924718,981815,942903,elderly,20211115
39,高知県,990396,500433,489963,elderly,20211115
40,福岡県,7199905,3666388,3533517,elderly,20211115
41,佐賀県,1141814,577178,564636,elderly,20211115
42,長崎県,1915566,968141,947425,elderly,20211115
43,熊本県,2532427,1280653,1251774,elderly,20211115
44,大分県,1599808,813067,786741,elderly,20211115
45,宮崎県,1520101,769513,750588,elderly,20211115
46,鹿児島県,2262356,1155805,1106551,elderly,20211115
47,沖縄県,1835554,935043,900511,elderly,20211115
1,北海道,7454000,3781625,3672375,elderly,20211122
2,青森県,1917977,970257,947720,elderly,20211122
3,岩手県,1824674,932773,891901,elderly,20211122
4,宮城県,3348909,1692572,1656337,elderly,20211122
5,秋田県,1487877,755010,732867,elderly,20211122
6,山形県,1627752,824069,803683,elderly,20211122
7,福島県,2770167,1407379,1362788,elderly,20211122
8,茨城県,4402644,2225147,2177497,elderly,20211122
9,栃木県,2905319,1474724,1430595,elderly,20211122
10,群馬県,2880384,1451079,1429305,elderly,20211122
11,埼玉県,10790523,5480428,5310095,elderly,20211122
12,千葉県,9257476,4694456,4563020,elderly,20211122
13,東京都,19906635,10059998,9846637,elderly,20211122
14,神奈川県,13522322,6827464,6694858,elderly,20211122
15,新潟県,3381734,1702764,1678970,elderly,20211122
16,富山県,1599474,808958,790516,elderly,20211122
17,石川県,1644324,830330,813994,elderly,20211122
18,福井県,1143470,576005,567465,elderly,20211122
19,山梨県,1202969,606046,596923,elderly,20211122
20,長野県,3052082,1543242,1508840,elderly,20211122
21,岐阜県,2984783,1503699,1481084,elderly,20211122
22,静岡県,5606317,2834465,2771852,elderly,20211122
23,愛知県,10669255,5380581,5288674,elderly,20211122
24,三重県,2627176,1328866,1298310,elderly,20211122
25,滋賀県,2074038,1048861,1025177,elderly,20211122
26,京都府,3547345,1794651,1752694,elderly,20211122
27,大阪府,12171040,6168125,6002915,elderly,20211122
28,兵庫県,7971374,4031937,3939437,elderly,20211122
29,奈良県,1955682,986974,968708,elderly,20211122
30,和歌山県,1322794,666753,656041,elderly,20211122
31,鳥取県,776358,391275,385083,elderly,20211122
32,島根県,978159,495257,482902,elderly,20211122
33,岡山県,2601752,1317161,1284591,elderly,20211122
34,広島県,3918817,1976973,1941844,elderly,20211122
35,山口県,1940071,977020,963051,elderly,20211122
36,徳島県,1046162,526625,519537,elderly,20211122
37,香川県,1368505,692057,676448,elderly,20211122
38,愛媛県,1947685,984501,963184,elderly,20211122
39,高知県,994372,501621,492751,elderly,20211122
40,福岡県,7252849,3677580,3575269,elderly,20211122
41,佐賀県,1135289,572690,562599,elderly,20211122
42,長崎県,1927062,972157,954905,elderly,20211122
43,熊本県,2544204,1282424,1261780,elderly,20211122
44,大分県,1613256,815887,797369,elderly,20211122
45,宮崎県,1528960,771112,757848,elderly,20211122
46,鹿児島県,2286161,1160529,1125632,elderly,20211122
47,沖縄県,1853953,940411,913542,elderly,20211122
1,北海道,7509138,3798089,3711049,elderly,20211129
2,青森県,1926374,972635,953739,elderly,20211129
3,岩手県,1844337,936001,908336,elderly,20211129
4,宮城県,3363145,1694859,1668286,elderly,20211129
5,秋田県,1499135,756651,742484,elderly,20211129
6,山形県,1638816,825381,813435,elderly,20211129
7,福島県,2790860,1411077,1379783,elderly,20211129
8,茨城県,4428628,2230786,2197842,elderly,20211129
9,栃木県,2933080,1477977,1455103,elderly,20211129
10,群馬県,2887678,1452906,1434772,elderly,20211129
11,埼玉県,10877205,5493931,5383274,elderly,20211129
12,千葉県,9326273,4710531,4615742,elderly,20211129
13,東京都,19987213,10066868,9920345,elderly,20211129
14,神奈川県,13607214,6847223,6759991,elderly,20211129
15,新潟県,3397231,1707554,1689677,elderly,20211129
16,富山県,1606211,809955,796256,elderly,20211129
17,石川県,1649426,831685,817741,elderly,20211129
18,福井県,1146130,576964,569166,elderly,20211129
19,山梨県,1208966,608090,600876,elderly,20211129
20,長野県,3067294,1546871,1520423,elderly,20211129
21,岐阜県,2997074,1506197,1490877,elderly,20211129
22,静岡県,5635800,2840661,2795139,elderly,20211129
23,愛知県,10711038,5391229,5319809,elderly,20211129
24,三重県,2643568,1334121,1309447,elderly,20211129
25,滋賀県,2088510,1051618,1036892,elderly,20211129
26,京都府,3574101,1805367,1768734,elderly,20211129
27,大阪府,12251910,6189142,6062768,elderly,20211129
28,兵庫県,8010472,4039661,3970811,elderly,20211129
29,奈良県,1964361,989045,975316,elderly,20211129
30,和歌山県,1326424,667830,658594,elderly,20211129
31,鳥取県,778256,392002,386254,elderly,20211129
32,島根県,983794,497992,485802,elderly,20211129
33,岡山県,2617511,1321482,1296029,elderly,20211129
34,広島県,3935421,1981518,1953903,elderly,20211129
35,山口県,1946203,979017,967186,elderly,20211129
36,徳島県,1048730,527656,521074,elderly,20211129
37,香川県,1377851,694852,682999,elderly,20211129
38,愛媛県,1957597,986316,971281,elderly,20211129
39,高知県,997086,502415,494671,elderly,20211129
40,福岡県,7301264,3686429,3614835,elderly,20211129
41,佐賀県,1139884,574211,565673,elderly,20211129
42,長崎県,1935642,975561,960081,elderly,20211129
43,熊本県,2555554,1287277,1268277,elderly,20211129
44,大分県,1622962,818038,804924,elderly,20211129
45,宮崎県,1536139,773382,762757,elderly,20211129
46,鹿児島県,2299749,1162374,1137375,elderly,20211129
47,沖縄県,1863836,942472,921364,elderly,20211129
1,北海道,7567088,3814984,3752104,elderly,20211206
2,青森県,1936013,974992,961021,elderly,20211206
3,岩手県,1857789,938625,919164,elderly,20211206
4,宮城県,3379730,1698465,1681265,elderly,20211206
5,秋田県,1504719,757326,747393,elderly,20211206
6,山形県,1645686,826880,818806,elderly,20211206
7,福島県,2807381,1414340,1393041,elderly,20211206
8,茨城県,4448511,2236979,2211532,elderly,20211206
9,栃木県,2945787,1480615,1465172,elderly,20211206
10,群馬県,2894041,1454939,1439102,elderly,20211206
11,埼玉県,10936895,5512445,5424450,elderly,20211206
12,千葉県,9379172,4726090,4653082,elderly,20211206
13,東京都,20060442,10097724,9962718,elderly,20211206
14,神奈川県,13670525,6869073,6801452,elderly,20211206
15,新潟県,3406432,1712156,1694276,elderly,20211206
16,富山県,1613327,810907,802420,elderly,20211206
17,石川県,1653190,832586,820604,elderly,20211206
18,福井県,1149301,578211,571090,elderly,20211206
19,山梨県,1212539,609269,603270,elderly,20211206
20,長野県,3079301,1549659,1529642,elderly,20211206
21,岐阜県,3004897,1508580,1496317,elderly,20211206
22,静岡県,5662059,2849431,2812628,elderly,20211206
23,愛知県,10752491,5405763,5346728,elderly,20211206
24,三重県,2656775,1337763,1319012,elderly,20211206
25,滋賀県,2096182,1053470,1042712,elderly,20211206
26,京都府,3596157,1812956,1783201,elderly,20211206
27,大阪府,12311055,6209224,6101831,elderly,20211206
28,兵庫県,8026338,4044321,3982017,elderly,20211206
29,奈良県,1970362,990917,979445,elderly,20211206
30,和歌山県,1324457,666227,658230,elderly,20211206
31,鳥取県,780502,392606,387896,elderly,20211206
32,島根県,990178,499877,490301,elderly,20211206
33,岡山県,2630374,1325731,1304643,elderly,20211206
34,広島県,3952820,1986311,1966509,elderly,20211206
35,山口県,1950574,980315,970259,elderly,20211206
36,徳島県,1051334,528624,522710,elderly,20211206
37,香川県,1381983,696162,685821,elderly,20211206
38,愛媛県,1965394,988514,976880,elderly,20211206
39,高知県,999502,503229,496273,elderly,20211206
40,福岡県,7331814,3696272,3635542,elderly,20211206
41,佐賀県,1143187,575419,567768,elderly,20211206
42,長崎県,1943965,978674,965291,elderly,20211206
43,熊本県,2564643,1289838,1274805,elderly,20211206
44,大分県,1626899,819154,807745,elderly,20211206
45,宮崎県,1540882,775364,765518,elderly,20211206
46,鹿児島県,2312026,1164254,1147772,elderly,20211206
47,沖縄県,1872784,945368,927416,elderly,20211206
1,北海道,7601056,3825724,3775332,elderly,20211213
2,青森県,1940192,976106,964086,elderly,20211213
3,岩手県,1868306,941107,927199,elderly,20211213
4,宮城県,3388889,1703127,1685762,elderly,20211213
5,秋田県,1510011,757586,752425,elderly,20211213
6,山形県,1647525,827352,820173,elderly,20211213
7,福島県,2813968,1416063,1397905,elderly,20211213
8,茨城県,4461596,2241559,2220037,elderly,20211213
9,栃木県,2951355,1482436,1468919,elderly,20211213
10,群馬県,2897475,1455933,1441542,elderly,20211213
11,埼玉県,10985496,5529105,5456391,elderly,20211213
12,千葉県,9411232,4734573,4676659,elderly,20211213
13,東京都,20129736,10127079,10002657,elderly,20211213
14,神奈川県,13711682,6883693,6827989,elderly,20211213
15,新潟県,3410924,1713610,1697314,elderly,20211213
16,富山県,1616634,811278,805356,elderly,20211213
17,石川県,1659457,833825,825632,elderly,20211213
18,福井県,1148257,577211,571046,elderly,20211213
19,山梨県,1215138,610084,605054,elderly,20211213
20,長野県,3087341,1552153,1535188,elderly,20211213
21,岐阜県,3008104,1509370,1498734,elderly,20211213
22,静岡県,5678520,2855196,2823324,elderly,20211213
23,愛知県,10780182,5414271,5365911,elderly,20211213
24,三重県,2665699,1340732,1324967,elderly,20211213
25,滋賀県,2099163,1054417,1044746,elderly,20211213
26,京都府,3611708,1819191,1792517,elderly,20211213
27,大阪府,12376346,6233775,6142571,elderly,20211213
28,兵庫県,8048376,4049622,3998754,elderly,20211213
29,奈良県,1976754,993090,983664,elderly,20211213
30,和歌山県,1326810,666792,660018,elderly,20211213
31,鳥取県,781877,392860,389017,elderly,20211213
32,島根県,993907,500378,493529,elderly,20211213
33,岡山県,2637622,1327622,1310000,elderly,20211213
34,広島県,3965285,1990955,1974330,elderly,20211213
35,山口県,1954267,981324,972943,elderly,20211213
36,徳島県,1053488,529090,524398,elderly,20211213
37,香川県,1386115,697181,688934,elderly,20211213
38,愛媛県,1969021,989952,979069,elderly,20211213
39,高知県,1001725,503769,497956,elderly,20211213
40,福岡県,7353502,3703152,3650350,elderly,20211213
41,佐賀県,1144748,575684,569064,elderly,20211213
42,長崎県,1947240,979248,967992,elderly,20211213
43,熊本県,2568233,1291017,1277216,elderly,20211213
44,大分県,1630976,820111,810865,elderly,20211213
45,宮崎県,1543250,776027,767223,elderly,20211213
46,鹿児島県,2319873,1165780,1154093,elderly,20211213
47,沖縄県,1877773,946738,931035,elderly,20211213
1,北海道,7634231,3836680,3797551,elderly,20211220
2,青森県,1943488,976965,966523,elderly,20211220
3,岩手県,1872494,941756,930738,elderly,20211220
4,宮城県,3393112,1705143,1687969,elderly,20211220
5,秋田県,1511161,758450,752711,elderly,20211220
6,山形県,1649604,827895,821709,elderly,20211220
7,福島県,2821492,1418221,1403271,elderly,20211220
8,茨城県,4433442,2226363,2207079,elderly,20211220
9,栃木県,2959728,1486118,1473610,elderly,20211220
10,群馬県,2901395,1457057,1444338,elderly,20211220
11,埼玉県,11010567,5536847,5473720,elderly,20211220
12,千葉県,9450158,4748928,4701230,elderly,20211220
13,東京都,20177677,10141943,10035734,elderly,20211220
14,神奈川県,13744572,6896707,6847865,elderly,20211220
15,新潟県,3417863,1715876,1701987,elderly,20211220
16,富山県,1617563,811668,805895,elderly,20211220
17,石川県,1662004,834635,827369,elderly,20211220
18,福井県,1150352,577925,572427,elderly,20211220
19,山梨県,1218722,611634,607088,elderly,20211220
20,長野県,3091383,1552949,1538434,elderly,20211220
21,岐阜県,3012006,1510864,1501142,elderly,20211220
22,静岡県,5691684,2859280,2832404,elderly,20211220
23,愛知県,10817147,5430604,5386543,elderly,20211220
24,三重県,2673335,1342419,1330916,elderly,20211220
25,滋賀県,2101418,1055284,1046134,elderly,20211220
26,京都府,3620288,1821189,1799099,elderly,20211220
27,大阪府,12440316,6258980,6181336,elderly,20211220
28,兵庫県,8069705,4055524,4014181,elderly,20211220
29,奈良県,1978982,993711,985271,elderly,20211220
30,和歌山県,1305564,655672,649892,elderly,20211220
31,鳥取県,783606,393514,390092,elderly,20211220
32,島根県,997162,500828,496334,elderly,20211220
33,岡山県,2644427,1329715,1314712,elderly,20211220
34,広島県,3973718,1994839,1978879,elderly,20211220
35,山口県,1957419,982381,975038,elderly,20211220
36,徳島県,1054920,529445,525475,elderly,20211220
37,香川県,1390698,698451,692247,elderly,20211220
38,愛媛県,1973720,992080,981640,elderly,20211220
39,高知県,1002399,503920,498479,elderly,20211220
40,福岡県,7370054,3709228,3660826,elderly,20211220
41,佐賀県,1147054,576286,570768,elderly,20211220
42,長崎県,1950867,980082,970785,elderly,20211220
43,熊本県,2574174,1292139,1282035,elderly,20211220
44,大分県,1632894,820600,812294,elderly,20211220
45,宮崎県,1547909,777945,769964,elderly,20211220
46,鹿児島県,2323265,1167001,1156264,elderly,20211220
47,沖縄県,1881258,947949,933309,elderly,20211220
1,北海道,7656983,3847456,3809527,elderly,20211227
2,青森県,1950420,979414,971006,elderly,20211227
3,岩手県,1877882,943215,934667,elderly,20211227
4,宮城県,3398629,1707633,1690996,elderly,20211227
5,秋田県,1512145,758582,753563,elderly,20211227
6,山形県,1652447,829390,823057,elderly,20211227
7,福島県,2828302,1420440,1407862,elderly,20211227
8,茨城県,4443021,2229489,2213532,elderly,20211227
9,栃木県,2958608,1484922,1473686,elderly,20211227
10,群馬県,2905343,1458513,1446830,elderly,20211227
11,埼玉県,11058966,5557227,5501739,elderly,20211227
12,千葉県,9446213,4743089,4703124,elderly,20211227
13,東京都,20224861,10158017,10066844,elderly,20211227
14,神奈川県,13783716,6914251,6869465,elderly,20211227
15,新潟県,3421097,1716536,1704561,elderly,20211227
16,富山県,1620759,812906,807853,elderly,20211227
17,石川県,1664496,835491,829005,elderly,20211227
18,福井県,1150514,577407,573107,elderly,20211227
19,山梨県,1223017,613748,609269,elderly,20211227
20,長野県,3097937,1555651,1542286,elderly,20211227
21,岐阜県,3016156,1513127,1503029,elderly,20211227
22,静岡県,5703272,2863024,2840248,elderly,20211227
23,愛知県,10832253,5435939,5396314,elderly,20211227
24,三重県,2677551,1344457,1333094,elderly,20211227
25,滋賀県,2106892,1057924,1048968,elderly,20211227
26,京都府,3632354,1825434,1806920,elderly,20211227
27,大阪府,12466263,6266031,6200232,elderly,20211227
28,兵庫県,8082832,4059333,4023499,elderly,20211227
29,奈良県,1982033,994861,987172,elderly,20211227
30,和歌山県,1336607,671057,665550,elderly,20211227
31,鳥取県,785096,394231,390865,elderly,20211227
32,島根県,999379,501439,497940,elderly,20211227
33,岡山県,2650326,1331103,1319223,elderly,20211227
34,広島県,3978275,1996812,1981463,elderly,20211227
35,山口県,1959465,983466,975999,elderly,20211227
36,徳島県,1056487,529975,526512,elderly,20211227
37,香川県,1392798,699205,693593,elderly,20211227
38,愛媛県,1980587,994790,985797,elderly,20211227
39,高知県,1004479,504727,499752,elderly,20211227
40,福岡県,7386096,3714746,3671350,elderly,20211227
41,佐賀県,1147598,576175,571423,elderly,20211227
42,長崎県,1954504,981152,973352,elderly,20211227
43,熊本県,2577142,1292992,1284150,elderly,20211227
44,大分県,1635579,821374,814205,elderly,20211227
45,宮崎県,1551751,779319,772432,elderly,20211227
46,鹿児島県,2326870,1168849,1158021,elderly,20211227
47,沖縄県,1886673,949998,936675,elderly,20211227
1,北海道,7656983,3847456,3809527,elderly,20220105
2,青森県,1950420,979414,971006,elderly,20220105
3,岩手県,1877882,943215,934667,elderly,20220105
4,宮城県,3398629,1707633,1690996,elderly,20220105
5,秋田県,1512145,758582,753563,elderly,20220105
6,山形県,1652447,829390,823057,elderly,20220105
7,福島県,2828302,1420440,1407862,elderly,20220105
8,茨城県,4443021,2229489,2213532,elderly,20220105
9,栃木県,2958608,1484922,1473686,elderly,20220105
10,群馬県,2905343,1458513,1446830,elderly,20220105
11,埼玉県,11058966,5557227,5501739,elderly,20220105
12,千葉県,9446213,4743089,4703124,elderly,20220105
13,東京都,20224861,10158017,10066844,elderly,20220105
14,神奈川県,13783716,6914251,6869465,elderly,20220105
15,新潟県,3421097,1716536,1704561,elderly,20220105
16,富山県,1620759,812906,807853,elderly,20220105
17,石川県,1664496,835491,829005,elderly,20220105
18,福井県,1150514,577407,573107,elderly,20220105
19,山梨県,1223017,613748,609269,elderly,20220105
20,長野県,3097937,1555651,1542286,elderly,20220105
21,岐阜県,3016156,1513127,1503029,elderly,20220105
22,静岡県,5703272,2863024,2840248,elderly,20220105
23,愛知県,10832253,5435939,5396314,elderly,20220105
24,三重県,2677551,1344457,1333094,elderly,20220105
25,滋賀県,2106892,1057924,1048968,elderly,20220105
26,京都府,3632354,1825434,1806920,elderly,20220105
27,大阪府,12466263,6266031,6200232,elderly,20220105
28,兵庫県,8082832,4059333,4023499,elderly,20220105
29,奈良県,1982033,994861,987172,elderly,20220105
30,和歌山県,1336607,671057,665550,elderly,20220105
31,鳥取県,785096,394231,390865,elderly,20220105
32,島根県,999379,501439,497940,elderly,20220105
33,岡山県,2650326,1331103,1319223,elderly,20220105
34,広島県,3978275,1996812,1981463,elderly,20220105
35,山口県,1959465,983466,975999,elderly,20220105
36,徳島県,1056487,529975,526512,elderly,20220105
37,香川県,1392798,699205,693593,elderly,20220105
38,愛媛県,1980587,994790,985797,elderly,20220105
39,高知県,1004479,504727,499752,elderly,20220105
40,福岡県,7386096,3714746,3671350,elderly,20220105
41,佐賀県,1147598,576175,571423,elderly,20220105
42,長崎県,1954504,981152,973352,elderly,20220105
43,熊本県,2577142,1292992,1284150,elderly,20220105
44,大分県,1635579,821374,814205,elderly,20220105
45,宮崎県,1551751,779319,772432,elderly,20220105
46,鹿児島県,2326870,1168849,1158021,elderly,20220105
47,沖縄県,1886673,949998,936675,elderly,20220105
1,北海道,7711411,3873280,3838131,elderly,20220111
2,青森県,1962689,984864,977825,elderly,20220111
3,岩手県,1890390,948912,941478,elderly,20220111
4,宮城県,3431199,1722284,1708915,elderly,20220111
5,秋田県,1520845,762708,758137,elderly,20220111
6,山形県,1662082,834035,828047,elderly,20220111
7,福島県,2849235,1430902,1418333,elderly,20220111
8,茨城県,4481316,2248671,2232645,elderly,20220111
9,栃木県,2979909,1495487,1484422,elderly,20220111
10,群馬県,2929584,1470597,1458987,elderly,20220111
11,埼玉県,11191878,5624759,5567119,elderly,20220111
12,千葉県,9536804,4787632,4749172,elderly,20220111
13,東京都,20655356,10375465,10279891,elderly,20220111
14,神奈川県,13930542,6989658,6940884,elderly,20220111
15,新潟県,3438097,1724672,1713425,elderly,20220111
16,富山県,1631584,818526,813058,elderly,20220111
17,石川県,1678431,842527,835904,elderly,20220111
18,福井県,1158382,581350,577032,elderly,20220111
19,山梨県,1233539,619074,614465,elderly,20220111
20,長野県,3125954,1569872,1556082,elderly,20220111
21,岐阜県,3039275,1524738,1514537,elderly,20220111
22,静岡県,5747399,2884934,2862465,elderly,20220111
23,愛知県,10940554,5490216,5450338,elderly,20220111
24,三重県,2699574,1354676,1344898,elderly,20220111
25,滋賀県,2127723,1068186,1059537,elderly,20220111
26,京都府,3671463,1843694,1827769,elderly,20220111
27,大阪府,12620275,6339300,6280975,elderly,20220111
28,兵庫県,8164776,4098844,4065932,elderly,20220111
29,奈良県,1996979,1002038,994941,elderly,20220111
30,和歌山県,1348908,677428,671480,elderly,20220111
31,鳥取県,790114,396709,393405,elderly,20220111
32,島根県,1005722,504400,501322,elderly,20220111
33,岡山県,2670870,1340835,1330035,elderly,20220111
34,広島県,4017972,2016081,2001891,elderly,20220111
35,山口県,1974595,990756,983839,elderly,20220111
36,徳島県,1064279,533933,530346,elderly,20220111
37,香川県,1403696,704350,699346,elderly,20220111
38,愛媛県,1990412,999455,990957,elderly,20220111
39,高知県,1011450,508174,503276,elderly,20220111
40,福岡県,7456811,3749192,3707619,elderly,20220111
41,佐賀県,1155871,580276,575595,elderly,20220111
42,長崎県,1971309,989430,981879,elderly,20220111
43,熊本県,2595150,1301932,1293218,elderly,20220111
44,大分県,1646421,826846,819575,elderly,20220111
45,宮崎県,1560529,783691,776838,elderly,20220111
46,鹿児島県,2337785,1174002,1163783,elderly,20220111
47,沖縄県,1911330,962308,949022,elderly,20220111
